name,taxonomy_id,taxonomy_lvl,kraken_assigned_reads,added_reads,new_est_reads,fraction_total_reads
Streptococcus sp. oral taxon 431,712633,S,784,36,820,0.00008
Neorhizobium sp. NCHU2750,1825976,S,1460,259,1719,0.00017
Pseudomonas sp. MT-1,150396,S,139,101,240,0.00002
Ahniella affigens,2021234,S,398,3,401,0.00004
Sinorhizobium sp. CCBAU 05631,794846,S,108,280,388,0.00004
Bacillus velezensis,492670,S,75,299,374,0.00004
Actinoplanes missouriensis,1866,S,309,181,490,0.00005
Acinetobacter sp. WCHAc010052,2004647,S,1916,465,2381,0.00023
Acinetobacter sp. WCHA55,2004646,S,50442,13893,64335,0.00634
Acinetobacter sp. WCHA45,2004644,S,27857,4725,32582,0.00321
Coprothermobacter proteolyticus,35786,S,11,0,11,0
Arcanobacterium phocae,131112,S,41,6,47,0
Actinomyces radingae,131110,S,164,13,177,0.00002
Candidatus Dependentiae bacterium (ex Spumella elongata CCAP 955/1),2066483,S,11,0,11,0
Halothece sp. PCC 7418,65093,S,17,4,21,0
Pseudomonas virus M6,347328,S,15,14,29,0
Treponema succinifaciens,167,S,527,35,562,0.00006
Polaribacter sp. MED152,313598,S,101,8,109,0.00001
Escherichia virus K30,1985722,S,12,10,22,0
Pseudarthrobacter chlorophenolicus,85085,S,115,32,147,0.00001
Klebsiella virus KpV289,1985727,S,23,5,28,0
Klebsiella virus KP32,1985726,S,17,9,26,0
Klebsiella virus Kp1,1985725,S,14,4,18,0
Truepera radiovictrix,332249,S,88,0,88,0.00001
Leclercia sp. LSNIH1,1920114,S,355,167,522,0.00005
Xanthomonas citri,346,S,1578,7190,8768,0.00086
Leclercia sp. LSNIH3,1920116,S,2084,2611,4695,0.00046
Citrobacter sp. CFNIH10,1920110,S,191,567,758,0.00007
Xanthomonas translucens,343,S,5846,938,6784,0.00067
Geobacter sp. M18,443143,S,692,196,888,0.00009
Geobacter sp. M21,443144,S,94,12,106,0.00001
Cutibacterium granulosum,33011,S,205,30,235,0.00002
Haloarcobacter bivalviorum,663364,S,377,13,390,0.00004
Microbacterium hominis,162426,S,3610,1000,4610,0.00045
Rhizobium sp. N324,1703969,S,40,769,809,0.00008
Lactobacillus virus LP65,298338,S,16,0,16,0
Streptomyces sp. M56,1495638,S,25,18,43,0
Saprospira grandis,1008,S,36,0,36,0
Sulfitobacter pseudonitzschiae,1402135,S,690,156,846,0.00008
Tamlana sp. UJ94,2069432,S,134,10,144,0.00001
Paenibacillus sp. FSL P4-0081,1536769,S,55,30,85,0.00001
Dokdonia sp. MED134,313590,S,17,11,28,0
Basilea psittacipulmonis,1472345,S,81,2,83,0.00001
Streptomyces sp. CFMR 7,1649184,S,25,27,52,0.00001
Mycobacterium sp. MS1601,1936029,S,1200,53,1253,0.00012
Streptomyces sp. fd1-xmd,1812480,S,94,14,108,0.00001
Streptosporangium sp. 'caverna',2202249,S,288,45,333,0.00003
Planctomyces sp. SH-PL62,1636152,S,407,32,439,0.00004
Candidatus Planktophila versatilis,1884905,S,37,2,39,0
Serratia plymuthica,82996,S,406,78,484,0.00005
Bacteriovorax stolpii,960,S,1900,3,1903,0.00019
Methanoplanus limicola,2315,S,11,4,15,0
Gynuella sunshinyii,1445505,S,136,0,136,0.00001
Peptostreptococcaceae bacterium oral taxon 929,2081703,S,291,9,300,0.00003
Actinomyces sp. oral taxon 897,2081702,S,418,57,475,0.00005
Pelagibaca abyssi,1250539,S,1010,653,1663,0.00016
Pseudomonas fragi,296,S,68237,70767,139004,0.0137
Hydrogenophilus thermoluteolus,297,S,297,7,304,0.00003
Pseudomonas fluorescens,294,S,33883,29937,63820,0.00629
Burkholderia cepacia,292,S,540,498,1038,0.0001
Brevundimonas diminuta,293,S,19068,6912,25980,0.00256
Bacillus phage 0305phi8-36,458639,S,13,0,13,0
Acinetobacter phage Petty,1406779,S,29,0,29,0
Enterococcus phage vB_EfaS_IME196,1747289,S,15,6,21,0
Curtobacterium pusillum,69373,S,257,94,351,0.00003
Providencia rettgeri,587,S,137,23,160,0.00002
Marivirga tractuosa,1006,S,64,16,80,0.00001
Pontibacter actiniarum,323450,S,71,15,86,0.00001
Cyanothece sp. ATCC 51142,43989,S,11,1,12,0
Thermus aquaticus,271,S,34,6,40,0
Corynebacterium epidermidicanis,1050174,S,58,3,61,0.00001
Thermus thermophilus,274,S,39,46,85,0.00001
Methanobacterium paludis,868131,S,41,0,41,0
Bacterioplanes sanyensis,1249553,S,142,3,145,0.00001
Pseudohongiella spirulinae,1249552,S,134,0,134,0.00001
Halomonas sp. JS92-SW72,2306583,S,672,28,700,0.00007
Bartonella apis,1686310,S,114,20,134,0.00001
Salmonella virus 9NA,1921123,S,15,0,15,0
Psychrobacter phage Psymv2,1071177,S,31,5,36,0
Prevotella sp. oral taxon 299,652716,S,86,23,109,0.00001
Scytonema sp. HK-05,1137095,S,18,18,36,0
Aequorivita sublithincola,101385,S,171,3,174,0.00002
Meiothermus silvanus,52022,S,84,6,90,0.00001
Rubrobacter indioceani,2051957,S,64,6,70,0.00001
Thermotoga caldifontis,1508419,S,14,23,37,0
Prevotella enoeca,76123,S,111,52,163,0.00002
Maribacter sp. MAR_2009_60,1250153,S,15,35,50,0
Devosia sp. I507,2083786,S,852,58,910,0.00009
Marinomonas mediterranea,119864,S,46,2,48,0
Polaribacter sp. SA4-10,754397,S,147,11,158,0.00002
Thermococcus litoralis,2265,S,16,11,27,0
Elizabethkingia ursingii,1756150,S,339,44,383,0.00004
Acinetobacter venetianus,52133,S,8813,683,9496,0.00094
Micavibrio aeruginosavorus,349221,S,276,1,277,0.00003
Serratia sp. SCBI,488142,S,35,118,153,0.00002
Pseudomonas sp. CCOS 191,1649877,S,207,67,274,0.00003
Frondihabitans sp. PAMC 28766,1795630,S,484,53,537,0.00005
Variovorax sp. PAMC 28711,1795631,S,4577,485,5062,0.0005
Aeromonas phage PX29,926067,S,22,2,24,0
[Eubacterium] minutum,76124,S,108,9,117,0.00001
Pseudoalteromonas translucida,166935,S,19,12,31,0
Pseudomonas mandelii,75612,S,1309,308,1617,0.00016
Rothia dentocariosa,2047,S,395,28,423,0.00004
Pimelobacter simplex,2045,S,1687,321,2008,0.0002
Psychrobacter sp. DAB_AL43B,1028416,S,27249,561,27810,0.00274
Desulfosporosinus youngiae,339862,S,113,8,121,0.00001
Jeotgalibaca dankookensis,708126,S,742,45,787,0.00008
Streptococcus phage 5093,646413,S,20,3,23,0
Shinella sp. HZN7,879274,S,32754,19367,52121,0.00514
Frankia symbiont of Datisca glomerata,656024,S,174,12,186,0.00002
Desulfitobacterium metallireducens,142877,S,81,4,85,0.00001
Acidobacteriaceae bacterium SBC82,2211140,S,90,6,96,0.00001
Libanicoccus massiliensis,1871022,S,1400,101,1501,0.00015
Vibrio owensii,696485,S,41,10,51,0.00001
Desulfohalobium retbaense,45663,S,84,0,84,0.00001
Lactococcus virus CB14,665884,S,140,67,207,0.00002
Thermodesulfobium acidiphilum,1794699,S,11,6,17,0
Lactococcus piscium,1364,S,5240,365,5605,0.00055
Weissella cibaria,137591,S,693,58,751,0.00007
Micromonospora sp. B006,2201999,S,103,54,157,0.00002
Saccharomonospora azurea,40988,S,142,33,175,0.00002
Saccharomonospora cyanea,40989,S,126,58,184,0.00002
Ammonifex degensii,42838,S,80,0,80,0.00001
Methanococcus maripaludis,39152,S,15,2,17,0
Lactococcus virus bIL170,63118,S,66,39,105,0.00001
Thalassolituus oleivorans,187493,S,628,25,653,0.00006
Gordonia phage BritBrat,1838064,S,155,0,155,0.00002
Halobacillus mangrovi,402384,S,31,0,31,0
Marinobacter sp. BSs20148,490759,S,36,18,54,0.00001
Enterococcus sp. FDAARGOS_375,2060307,S,550,672,1222,0.00012
Murdochiella vaginalis,1852373,S,151,10,161,0.00002
Streptomyces bacillaris,68179,S,38,29,67,0.00001
Actinomyces pacaensis,1852377,S,489,31,520,0.00005
Zymobacter palmae,33074,S,105,6,111,0.00001
Ezakiella massiliensis,1852374,S,130,10,140,0.00001
Kitasatospora albolonga,68173,S,76,107,183,0.00002
Curvibacter sp. AEP1-3,1844971,S,6817,171,6988,0.00069
Clostridium saccharoperbutylacetonicum,36745,S,252,1,253,0.00002
Akkermansia glycaniphila,1679444,S,699,0,699,0.00007
Planococcus maritimus,192421,S,68,6,74,0.00001
Bifidobacterium thermophilum,33905,S,4279,109,4388,0.00043
Xanthomonas oryzae,347,S,1251,127,1378,0.00014
Thermacetogenium phaeum,85874,S,99,33,132,0.00001
Dietzia psychralcaliphila,139021,S,347,72,419,0.00004
Desulfotomaculum reducens,59610,S,57,1,58,0.00001
Alicycliphilus denitrificans,179636,S,30578,25756,56334,0.00555
Cystobacter fuscus,43,S,299,121,420,0.00004
Brevundimonas naejangsanensis,588932,S,8228,1208,9436,0.00093
Pseudomonas sp. bs2935,1761895,S,68,3076,3144,0.00031
Cellulosilyticum lentocellum,29360,S,279,1,280,0.00003
Pseudomonas sp. HLS-6,2049589,S,1094,91,1185,0.00012
Candidatus Erwinia sp. ErCipseudotaxifoliae,1922217,S,11,0,11,0
Amycolatopsis japonica,208439,S,83,87,170,0.00002
Dictyoglomus turgidum,513050,S,19,0,19,0
Mycobacterium virus Konstantine,1982364,S,16,59,75,0.00001
Mycobacterium virus Predator,1982365,S,1237,0,1237,0.00012
Lactobacillus ruminis,1623,S,11422,192,11614,0.00114
[Mannheimia] succiniciproducens,157673,S,253,12,265,0.00003
Sulfitobacter phage EE36phi1,490913,S,14,0,14,0
Silicibacter phage DSS3phi2,490912,S,90,2,92,0.00001
Lactobacillus sanfranciscensis,1625,S,188,6,194,0.00002
Lactobacillus salivarius,1624,S,2901,167,3068,0.0003
Desulfovibrio alaskensis,58180,S,1071,838,1909,0.00019
Weissella viridescens,1629,S,59,3,62,0.00001
Bacteroidales bacterium CF,1400053,S,2350,181,2531,0.00025
Kocuria flava,446860,S,449,78,527,0.00005
Legionella lansingensis,45067,S,19,0,19,0
Enterobacter roggenkampii,1812935,S,2055,2385,4440,0.00044
Oceanicoccus sagamiensis,716816,S,59,0,59,0.00001
Halopenitus persicus,1048396,S,10,0,10,0
Nostoc piscinale,224012,S,15,7,22,0
Streptomyces sp. CCM_MD2014,1561022,S,90,16,106,0.00001
Pseudomonas furukawaii,1149133,S,836,71,907,0.00009
Burkholderia sp. Bp7605,1740163,S,339,31,370,0.00004
Rhodovulum sp. P5,1564506,S,904,89,993,0.0001
Streptomyces puniciscabiei,164348,S,115,11,126,0.00001
Pectobacterium carotovorum,554,S,401,107,508,0.00005
Dickeya chrysanthemi,556,S,215,5,220,0.00002
Enterobacter cloacae,550,S,13843,22061,35904,0.00354
Pantoea ananatis,553,S,357,14,371,0.00004
Erwinia amylovora,552,S,92,30,122,0.00001
Frankia inefficax,298654,S,303,24,327,0.00003
Thermanaerovibrio velox,108007,S,36,18,54,0.00001
Pseudoalteromonas spongiae,298657,S,71,5,76,0.00001
Microbacterium sp. XT11,367477,S,1154,167,1321,0.00013
Frankia sp. EAN1pec,298653,S,225,18,243,0.00002
Weissella jogaejeotgali,1631871,S,122,20,142,0.00001
Thioclava nitratireducens,1915078,S,1015,161,1176,0.00012
Calothrix brevissima,938406,S,22,15,37,0
Staphylococcus cohnii,29382,S,133,11,144,0.00001
Microchaete diplosiphon,1197,S,19,28,47,0
Oenococcus kitaharae,336988,S,25,0,25,0
Escherichia virus V5,1914853,S,148,92,240,0.00002
Citrobacter sp. 92,2019568,S,17,424,441,0.00004
Chthonomonas calidirosea,454171,S,32,0,32,0
Escherichia virus FV3,1914855,S,104,8,112,0.00001
Corynebacterium falsenii,108486,S,188,65,253,0.00002
Stenotrophomonas nitritireducens,83617,S,11,13907,13918,0.00137
Pseudopropionibacterium propionicum,1750,S,649,63,712,0.00007
Chryseobacterium sp. T16E-39,2015076,S,603,185,788,0.00008
Citrobacter freundii complex sp. CFNIH4,2077148,S,1261,6566,7827,0.00077
Citrobacter freundii complex sp. CFNIH9,2077149,S,1245,3157,4402,0.00043
Arthrobacter sp. ATCC 21022,1771959,S,22,66,88,0.00001
Bradyrhizobium sp. WSM471,319017,S,134,288,422,0.00004
Sphaerochaeta coccoides,273376,S,38,0,38,0
Staphylococcus kloosii,29384,S,56,2,58,0.00001
Citrobacter freundii complex sp. CFNIH3,2077147,S,6514,9787,16301,0.00161
Methylobacterium currus,2051553,S,873,230,1103,0.00011
Mycobacterium sp. PYR15,2051552,S,219,143,362,0.00004
Kocuria rhizophila,72000,S,268,552,820,0.00008
Pseudomonas vancouverensis,95300,S,827,65,892,0.00009
Microcella alkaliphila,279828,S,773,80,853,0.00008
Synechococcus sp. KORDI-52,585425,S,33,17,50,0
Mycolicibacterium vaccae,1810,S,1264,181,1445,0.00014
Brevundimonas sp. GW460-12-10-14-LB2,1827469,S,5493,4298,9791,0.00097
Pseudomonas sp. LG1E9,2219057,S,1418,208,1626,0.00016
Pandoraea oxalativorans,573737,S,573,277,850,0.00008
Staphylococcus simulans,1286,S,69,3,72,0.00001
Bacillus jeotgali,129985,S,57,2,59,0.00001
Staphylococcus aureus,1280,S,633,1354,1987,0.0002
Staphylococcus haemolyticus,1283,S,379,43,422,0.00004
Staphylococcus epidermidis,1282,S,558,54,612,0.00006
[Bacillus] selenitireducens,85683,S,41,5,46,0
Staphylococcus xylosus,1288,S,42,1,43,0
Psychrobacter sp. G,571800,S,25903,15199,41102,0.00405
Fimbriimonas ginsengisoli,1005039,S,78,0,78,0.00001
Lactobacillus acidophilus,1579,S,1183,21,1204,0.00012
Dyella thiooxydans,445710,S,1179,242,1421,0.00014
Auricoccus indicus,1849491,S,54,3,57,0.00001
Geminocystis sp. NIES-3709,1617448,S,44,4,48,0
Elizabethkingia miricola,172045,S,186,113,299,0.00003
Vibrio gazogenes,687,S,50,0,50,0
Leuconostoc kimchii,136609,S,26,142,168,0.00002
Vibrio campbellii,680,S,68,21,89,0.00001
Leifsonia xyli,1575,S,1068,328,1396,0.00014
Mycobacterium sp. JS623,212767,S,986,27,1013,0.0001
Salegentibacter salegens,143223,S,66,5,71,0.00001
Paludibacter propionicigenes,185300,S,730,1,731,0.00007
Chromobacterium vaccinii,1108595,S,666,200,866,0.00009
Nitrosospira lacus,1288494,S,158,12,170,0.00002
Marmoricola scoriae,642780,S,751,181,932,0.00009
Arthrobacter sp. YC-RL1,1652545,S,435,39,474,0.00005
Nostoc sp. PCC 7107,317936,S,12,5,17,0
Microbacterium pygmaeum,370764,S,1363,98,1461,0.00014
Candidatus Nanopelagicus limnes,1884634,S,24,12,36,0
Capnocytophaga canimorsus,28188,S,166,29,195,0.00002
Capnocytophaga cynodegmi,28189,S,70,21,91,0.00001
Phyllobacterium zundukense,1867719,S,515,37,552,0.00005
Acetohalobium arabaticum,28187,S,29,0,29,0
Leptospira santarosai,28183,S,12,0,12,0
Actinomyces sp. oral taxon 414,712122,S,1584,389,1973,0.00019
Streptococcus porcinus,1340,S,1092,46,1138,0.00011
Methylobacillus flagellatus,405,S,577,78,655,0.00006
Planococcus kocurii,1374,S,12,23,35,0
Aerococcus viridans,1377,S,1572,366,1938,0.00019
Aerococcus urinae,1376,S,84,1,85,0.00001
Vibrio phage pYD38-A,754051,S,94,7,101,0.00001
Lactobacillus crispatus,47770,S,2119,63,2182,0.00022
Methylorubrum extorquens,408,S,1035,1086,2121,0.00021
Bacteroides caccae,47678,S,1261,18,1279,0.00013
Sphingopyxis sp. MG,1866325,S,894,4610,5504,0.00054
Pseudomonas granadensis,1421430,S,297,142,439,0.00004
Acinetobacter sp. WCHAc010005,2004650,S,2151,633,2784,0.00027
Haemophilus pittmaniae,249188,S,122,7,129,0.00001
Acholeplasma laidlawii,2148,S,52,18,70,0.00001
Pseudopedobacter saltans,151895,S,196,54,250,0.00002
Methanoregula formicica,882104,S,47,3,50,0
Variovorax sp. HW608,1034889,S,5325,507,5832,0.00057
Streptococcus iniae,1346,S,1022,116,1138,0.00011
Spirosoma montaniterrae,1178516,S,69,4,73,0.00001
Pseudomonas alcaligenes,43263,S,16418,687,17105,0.00169
Macrococcus caseolyticus,69966,S,37,13,50,0
Pseudomonas litoralis,797277,S,441,13,454,0.00004
Alteromonas naphthalenivorans,715451,S,52,21,73,0.00001
Pandoraea pulmonicola,93221,S,488,75,563,0.00006
Pandoraea pnomenusa,93220,S,1200,343,1543,0.00015
Pandoraea sputorum,93222,S,363,151,514,0.00005
Delftia tsuruhatensis,180282,S,7071,8119,15190,0.0015
Pseudomonas salegens,1434072,S,391,3,394,0.00004
Bradyrhizobium sp. ORS 285,115808,S,581,111,692,0.00007
Pseudomonas virus LKA1,1985731,S,65,0,65,0.00001
Martelella endophytica,1486262,S,701,92,793,0.00008
Methylophilus sp. TWE2,1662285,S,305,12,317,0.00003
Xylella virus Prado,1985736,S,73,0,73,0.00001
Brachybacterium sp. P6-10-X1,1903186,S,291,48,339,0.00003
Bacillus thermoamylovorans,35841,S,66,6,72,0.00001
Aeromonas sp. ASNIH7,1920107,S,884,1924,2808,0.00028
Methanosphaera stadtmanae,2317,S,364,4,368,0.00004
Streptomyces malaysiensis,92644,S,12,9,21,0
Herbaspirillum frisingense,92645,S,986,202,1188,0.00012
Agrobacterium vitis,373,S,1080,57,1137,0.00011
Enterobacteriaceae bacterium ENNIH2,1920109,S,505,15184,15689,0.00155
Bradyrhizobium japonicum,375,S,642,788,1430,0.00014
Bradyrhizobium sp.,376,S,143,339,482,0.00005
Capnocytophaga sputigena,1019,S,71,16,87,0.00001
Pseudomonas balearica,74829,S,1021,266,1287,0.00013
Tsukamurella paurometabola,2061,S,602,81,683,0.00007
Ruegeria sp. TM1040,292414,S,293,57,350,0.00003
Caulobacter henricii,69395,S,844,164,1008,0.0001
Pseudomonas sp. NS1(2017),2025658,S,1349,278,1627,0.00016
Paenibacillus sp. FSL R7-0273,1536772,S,132,15,147,0.00001
Paenibacillus sp. FSL R7-0331,1536773,S,80,9,89,0.00001
Neorhizobium galegae,399,S,2317,215,2532,0.00025
Rhizobium tropici,398,S,1036,102,1138,0.00011
Paenibacillus sp. FSL H7-0357,1536774,S,80,6,86,0.00001
Pseudomonas extremaustralis,359110,S,3412,424,3836,0.00038
Colwellia sp. Arc7-D,2161872,S,42,9,51,0.00001
Obesumbacterium proteus,82983,S,222,45,267,0.00003
Butyrivibrio hungatei,185008,S,504,168,672,0.00007
Candidatus Planktophila lacus,1884913,S,21,1,22,0
Candidatus Planktophila dulcis,1884914,S,17,2,19,0
Tatumella ptyseos,82987,S,80,3,83,0.00001
Candidatus Nanopelagicus abundans,1884916,S,12,3,15,0
Pragia fontium,82985,S,68,0,68,0.00001
Caulobacteraceae bacterium OTSz_A_272,1759059,S,159,0,159,0.00002
Deinococcus irradiatisoli,2202254,S,68,2,70,0.00001
Saccharomonospora glauca,40990,S,196,57,253,0.00002
Staphylococcus felis,46127,S,63,2,65,0.00001
Nitrosomonas sp. AL212,153948,S,45,41,86,0.00001
Acidihalobacter ferrooxidans,1765967,S,1080,23,1103,0.00011
Chloroherpeton thalassium,100716,S,34,0,34,0
Nautilia profundicola,244787,S,28,0,28,0
Alicyclobacillus acidocaldarius,405212,S,134,0,134,0.00001
Malacobacter molluscorum,1032072,S,312,27,339,0.00003
Christensenella massiliensis,1805714,S,1085,55,1140,0.00011
Rhizobium sp. IE4771,1301032,S,129,283,412,0.00004
Citrobacter sp. FDAARGOS_156,1702170,S,2783,362,3145,0.00031
Acidimicrobium ferrooxidans,53635,S,60,0,60,0.00001
Brenneria goodwinii,1109412,S,115,4,119,0.00001
Candidatus Phaeomarinobacter ectocarpi,1458461,S,174,2,176,0.00002
Burkholderiales bacterium YL45,1834205,S,237,3,240,0.00002
Shewanella sp. W3-18-1,351745,S,40,126,166,0.00002
Weissella paramesenteroides,1249,S,147,22,169,0.00002
Achromobacter denitrificans,32002,S,1218,813,2031,0.0002
Salmonella virus SE2,2005699,S,36,34,70,0.00001
Candidatus Rhodoluna planktonica,535712,S,35,3,38,0
Kozakia baliensis,153496,S,148,24,172,0.00002
Prosthecochloris sp. CIB 2401,1868325,S,156,10,166,0.00002
Salmonella virus SETP7,2005692,S,16,4,20,0
Altererythrobacter ishigakiensis,476157,S,154,4,158,0.00002
Lactococcus phage r1t,43685,S,12,17,29,0
Dickeya solani,1089444,S,81,10,91,0.00001
Dehalobacter restrictus,55583,S,40,1,41,0
Bacillus sonorensis,119858,S,40,1,41,0
Rhizobium sp. NXC24,2048897,S,1101,85,1186,0.00012
Petrotoga mobilis,69499,S,23,4,27,0
Burkholderia virus Bcep22,242527,S,11,0,11,0
Pseudonocardia sp. AL041005-10,445576,S,213,108,321,0.00003
Alkalitalea saponilacus,889453,S,135,2,137,0.00001
Tessaracoccus sp. T2.5-30,1909732,S,2316,268,2584,0.00025
Candidatus Pelagibacter sp. IMCC9063,1002672,S,20,0,20,0
Chryseobacterium taklimakanense,536441,S,5858,2625,8483,0.00084
Mycobacteroides saopaulense,1578165,S,404,37,441,0.00004
Caldilinea aerophila,133453,S,130,7,137,0.00001
Jonquetella anthropi,428712,S,111,4,115,0.00001
Streptococcus phage Str-PAP-1,1589270,S,316,0,316,0.00003
Chryseolinea sp. KIS68-18,2321403,S,84,0,84,0.00001
Bacillus pseudofirmus,79885,S,39,1,40,0
Lactobacillus helveticus,1587,S,1124,398,1522,0.00015
Leptospira interrogans,173,S,28,-3,25,0
Leptospira biflexa,172,S,215,-215,0,0
Mobiluncus curtisii,2051,S,109,14,123,0.00001
Moraxella ovis,29433,S,1218,1012,2230,0.00022
Gordonia terrae,2055,S,1313,372,1685,0.00017
Gordonia bronchialis,2054,S,2074,437,2511,0.00025
Sphaerobacter thermophilus,2057,S,104,2,106,0.00001
Stenotrophomonas sp. WZN-1,2005046,S,444,638,1082,0.00011
Halomonas sp. A3H3,1346287,S,209,35,244,0.00002
Eggerthella lenta,84112,S,4930,440,5370,0.00053
Oscillatoria acuminata,118323,S,33,3,36,0
Slackia heliotrinireducens,84110,S,386,0,386,0.00004
Corynebacterium uterequi,1072256,S,128,4,132,0.00001
Capnocytophaga gingivalis,1017,S,40,3,43,0
Enterococcus phage IME-EFm1,1445858,S,13,0,13,0
Blattabacterium sp. (Nauphoeta cinerea),1316444,S,13,3,16,0
Peptoniphilus sp. ING2-D1G,1912856,S,224,8,232,0.00002
Enterococcus mundtii,53346,S,294,19,313,0.00003
Enterococcus durans,53345,S,882,321,1203,0.00012
Paenibacillus sp. FSL R5-0912,1536771,S,65,33,98,0.00001
Sphingobium sp. RAC03,1843368,S,688,65,753,0.00007
Methanosarcina lacustris,170861,S,14,0,14,0
Vibrio scophthalmi,45658,S,49,4,53,0.00001
Vitreoscilla sp. C1,96942,S,9117,684,9801,0.00097
Rubrobacter xylanophilus,49319,S,111,2,113,0.00001
Cupriavidus pinatubonensis,248026,S,987,196,1183,0.00012
Pseudoalteromonas aliena,247523,S,11,2,13,0
Shewanella phage Spp001,1445859,S,33,1,34,0
Pseudomonas alkylphenolica,237609,S,941,71,1012,0.0001
Pseudoxanthomonas spadix,415229,S,5601,1783,7384,0.00073
Bartonella vinsonii,33047,S,27,19,46,0
Bartonella grahamii,33045,S,17,25,42,0
Thermovirga lienii,336261,S,19,2,21,0
Sulfitobacter sp. AM1-D1,1917485,S,612,792,1404,0.00014
Halothermothrix orenii,31909,S,19,0,19,0
Enterobacter phage EcP1,942016,S,24,0,24,0
Bacteroides cellulosilyticus,246787,S,1032,62,1094,0.00011
Lactobacillus acetotolerans,1600,S,96,3,99,0.00001
Filimonas lacunae,477680,S,65,14,79,0.00001
Lactobacillus amylophilus,1603,S,2357,472,2829,0.00028
Gemmatimonas aurantiaca,173480,S,280,12,292,0.00003
Yersinia phage phiR1-37,331278,S,32,0,32,0
Exiguobacterium antarcticum,132920,S,34,3,37,0
Pantoea rwandensis,1076550,S,227,10,237,0.00002
Meiothermus ruber,277,S,117,10,127,0.00001
Mesoplasma florum,2151,S,11,20,31,0
Pseudomonas sp. FDAARGOS_380,2018067,S,14615,5927,20542,0.00202
Salmonella virus SKML39,2169690,S,10,7,17,0
[Clostridium] sphenoides,29370,S,1528,63,1591,0.00016
Sphingorhabdus sp. Alg231-15,1922222,S,102,1,103,0.00001
Erythrobacter sp. Alg231-14,1922225,S,102,1,103,0.00001
Anderseniella sp. Alg231-50,1922226,S,178,2,180,0.00002
Lactobacillus oligofermentans,293371,S,140,5,145,0.00001
Opitutus terrae,107709,S,267,8,275,0.00003
Staphylococcus auricularis,29379,S,25,0,25,0
Microbacterium sp. No. 7,1714373,S,3296,1153,4449,0.00044
Faecalibaculum rodentium,1702221,S,493,80,573,0.00006
Cronobacter phage vB_CsaM_GAP161,1141138,S,62,20,82,0.00001
endosymbiont 'TC1' of Trimyema compressum,243899,S,139,0,139,0.00001
Streptomyces chartreusis,1969,S,223,22,245,0.00002
Methylomicrobium album,39775,S,304,7,311,0.00003
Rhodoferax ferrireducens,192843,S,5721,230,5951,0.00059
Aminobacter aminovorans,83263,S,1456,314,1770,0.00017
Lactobacillus farciminis,1612,S,128,1,129,0.00001
Lactobacillus fermentum,1613,S,4449,523,4972,0.00049
Acinetobacter nosocomialis,106654,S,1463,102,1565,0.00015
Sphingobium sp. EP60837,1855519,S,478,64,542,0.00005
Bradyrhizobium oligotrophicum,44255,S,723,109,832,0.00008
Erwinia gerundensis,1619313,S,301,16,317,0.00003
Paenibacillus durus,44251,S,100,7,107,0.00001
Paenibacillus beijingensis,1126833,S,105,6,111,0.00001
Candidatus Phycorickettsia trachydisci,2115978,S,22,0,22,0
Streptomyces nodosus,40318,S,116,8,124,0.00001
Pseudomonas virus PAE1,1981048,S,14,13,27,0
Dietzia sp. oral taxon 368,712270,S,394,178,572,0.00006
Fastidiosipila sanguinis,236753,S,60,2,62,0.00001
Clostridiaceae bacterium 14S0207,2082193,S,188,19,207,0.00002
Klebsiella virus PKP126,1981042,S,34,7,41,0
Klebsiella virus Sushi,1981043,S,27,7,34,0
Cupriavidus metallidurans,119219,S,3558,2593,6151,0.00061
Erwinia phage PhiEaH1,1401669,S,15,0,15,0
Candidatus Nucleicultrix amoebiphila,1509244,S,21,0,21,0
Haliangium ochraceum,80816,S,434,10,444,0.00004
Bradyrhizobium lablabi,722472,S,674,2098,2772,0.00027
Acidihalobacter prosperus,160660,S,670,25,695,0.00007
Leadbetterella byssophila,316068,S,270,16,286,0.00003
Anomala cuprea entomopoxvirus,62099,S,10,0,10,0
Sulfuritalea hydrogenivorans,748811,S,1597,82,1679,0.00017
Komagataeibacter nataicola,265960,S,136,19,155,0.00002
Hymenobacter nivis,1850093,S,70,23,93,0.00001
Pseudomonas veronii,76761,S,1800,1697,3497,0.00034
Pseudomonas rhodesiae,76760,S,4185,1476,5661,0.00056
Paenibacillus sp. 32O-W,1695218,S,78,4,82,0.00001
Sphingomonas indica,941907,S,473,11,484,0.00005
Betaproteobacteria bacterium GR16-43,1904640,S,621,9,630,0.00006
Cupriavidus sp. USMAHM13,1389192,S,51,309,360,0.00004
Halomonas subglaciescola,29571,S,221,4,225,0.00002
Brachyspira hampsonii,1287055,S,18,4,22,0
Taylorella equigenitalis,29575,S,39,5,44,0
Aeromonas sp. ASNIH2,1636607,S,1625,3102,4727,0.00047
Aeromonas sp. ASNIH1,1636606,S,1072,2644,3716,0.00037
Mycobacterium kansasii,1768,S,641,90,731,0.00007
Mycobacterium leprae,1769,S,76,0,76,0.00001
Acinetobacter sp. ACNIH1,1636603,S,5803,980,6783,0.00067
Myxococcus stipitatus,83455,S,164,26,190,0.00002
Gluconacetobacter diazotrophicus,33996,S,362,22,384,0.00004
Aquabacterium olei,1296669,S,3751,906,4657,0.00046
Mycolicibacterium fortuitum,1766,S,392,2212,2604,0.00026
Phenylobacterium zucineum,284016,S,2155,290,2445,0.00024
Mannheimia sp. USDA-ARS-USMARC-1261,1432056,S,142,43,185,0.00002
Aeromonas sp. ASNIH3,1636608,S,735,1833,2568,0.00025
Cyanobium sp. NIES-981,1851505,S,201,50,251,0.00002
Synechocystis sp. PCC 6714,1147,S,23,21,44,0
Klebsiella virus KpV475,1980958,S,11,5,16,0
Pseudolabrys taiwanensis,331696,S,747,71,818,0.00008
Klebsiella virus KpV41,1980956,S,19,12,31,0
Klebsiella virus Kp2,1980955,S,30,10,40,0
Synechococcus sp. CC9902,316279,S,16,2,18,0
Cyclobacterium marinum,104,S,44,4,48,0
Collimonas arenae,279058,S,1027,157,1184,0.00012
Granulicella mallensis,940614,S,70,8,78,0.00001
Granulicella tundricola,940615,S,78,12,90,0.00001
Salmonella virus UAB87,1965383,S,16,17,33,0
Escherichia virus VpaE1,1965382,S,30,27,57,0.00001
Salinibacter ruber,146919,S,111,3,114,0.00001
Bacillus sp. FJAT-45348,2011012,S,59,2,61,0.00001
Erwinia virus Ea214,1965384,S,57,0,57,0.00001
Vibrio diabolicus,50719,S,24,26,50,0
Vibrio natriegens,691,S,22,32,54,0.00001
Clostridium novyi,1542,S,58,2,60,0.00001
Photobacterium damselae,38293,S,521,47,568,0.00006
Aerococcus sanguinicola,119206,S,37,0,37,0
Pseudomonas virus F116,280701,S,15,16,31,0
Clostridium scatologenes,1548,S,39,1,40,0
Zymomonas mobilis,542,S,1180,650,1830,0.00018
Aeromonas virus Aes508,1921531,S,23,11,34,0
Citrobacter freundii,546,S,17707,21852,39559,0.0039
Citrobacter koseri,545,S,1108,95,1203,0.00012
Klebsiella aerogenes,548,S,2036,386,2422,0.00024
Pantoea agglomerans,549,S,1918,329,2247,0.00022
Dipteran ambidensovirus 1,1513186,S,108,0,108,0.00001
Flavobacterium sp. CJ74,2294119,S,94,2,96,0.00001
Cellulomonas gilvus,11,S,478,177,655,0.00006
Dechloromonas aromatica,259537,S,7906,942,8848,0.00087
Mycobacterium sp. WY10,1920667,S,234,153,387,0.00004
Mycobacterium simiae,1784,S,611,39,650,0.00006
Halocynthiibacter arcticus,1579316,S,124,4,128,0.00001
Carboxydothermus hydrogenoformans,129958,S,32,0,32,0
Micromonospora krabiensis,307121,S,161,41,202,0.00002
Candidatus Saccharibacteria oral taxon TM7x,1476577,S,1411,20,1431,0.00014
Microbacterium sp. str. 'China',2103230,S,141,1518,1659,0.00016
Stenotrophomonas sp. LM091,1904944,S,2801,1212,4013,0.0004
Selenomonas sp. oral taxon 136,713030,S,60,132,192,0.00002
Geobacillus thermocatenulatus,33938,S,13,23,36,0
Leifsonia sp. 21MFCrub1.1,1798223,S,388,475,863,0.00009
Aeromicrobium choanae,1736691,S,494,85,579,0.00006
Streptococcus macedonicus,59310,S,22708,56114,78822,0.00777
Jiangella sp. DSM 45060,1798224,S,382,93,475,0.00005
Providencia alcalifaciens,126385,S,147,6,153,0.00002
Dickeya sp. Secpp 1600,2037915,S,67,42,109,0.00001
Brachybacterium saurashtrense,556288,S,279,82,361,0.00004
Methylococcus capsulatus,414,S,539,19,558,0.00005
Colwellia psychrerythraea,28229,S,74,4,78,0.00001
Aquitalea magnusonii,332411,S,1068,134,1202,0.00012
Exiguobacterium sibiricum,332410,S,66,6,72,0.00001
Desulfobacula toluolica,28223,S,58,5,63,0.00001
Pseudomonas sp. URMO17WK12:I11,1283291,S,831,476,1307,0.00013
Lactococcus virus jj50,213775,S,33,55,88,0.00001
Mycoplasma penetrans,28227,S,32,0,32,0
Atopobium parvulum,1382,S,131,1,132,0.00001
Bacteroides helcogenes,290053,S,336,2,338,0.00003
Lentzea guizhouensis,1586287,S,304,44,348,0.00003
Escherichia virus JES2013,1914854,S,164,94,258,0.00003
Winogradskyella sp. RHA_55,1249933,S,85,14,99,0.00001
Thiomonas sp. X19,1050370,S,1631,108,1739,0.00017
Fusobacterium ulcerans,861,S,299,45,344,0.00003
Streptomyces sp. HNM0039,2174846,S,89,10,99,0.00001
Desulfarculus baarsii,453230,S,649,251,900,0.00009
Dehalobacter sp. DCA,1147129,S,10,6,16,0
Ruegeria sp. AD91A,2293862,S,272,17,289,0.00003
Bacillus oceanisediminis,665099,S,107,4,111,0.00001
Klebsiella virus KP36,1920861,S,25,8,33,0
Klebsiella virus 1513,1920862,S,25,7,32,0
Salinimonas sp. HMF8227,2183582,S,101,1,102,0.00001
Streptomyces koyangensis,188770,S,62,17,79,0.00001
Campylobacter helveticus,28898,S,16,0,16,0
Stanieria cyanosphaera,102116,S,38,7,45,0
Novosphingobium sp. THN1,1016987,S,1407,79,1486,0.00015
Shigella virus EP23,1954379,S,17,5,22,0
Stenotrophomonas phage Smp131,1168563,S,18,1,19,0
Corynebacterium terpenotabidum,89154,S,2020,163,2183,0.00022
Chroococcidiopsis thermalis,54299,S,52,2,54,0.00001
Leptotrichia sp. oral taxon 847,1785996,S,368,371,739,0.00007
Pseudomonas citronellolis,53408,S,1382,151,1533,0.00015
Acetobacter senegalensis,446692,S,39,28,67,0.00001
Campylobacter iguaniorum,1244531,S,48,0,48,0
Zobellia galactanivorans,63186,S,52,0,52,0.00001
Candidatus Saccharibacteria bacterium YM_S32_TM7_50_20,2056494,S,160,0,160,0.00002
Aliiarcobacter trophiarum,708186,S,8797,757,9554,0.00094
Liberibacter crescens,1273132,S,22,1,23,0
Treponema azotonutricium,150829,S,42,0,42,0
Thermosipho melanesiensis,46541,S,12,6,18,0
Chryseobacterium glaciei,1685010,S,1022,213,1235,0.00012
Salegentibacter sp. T436,1729720,S,102,58,160,0.00002
Sinorhizobium fredii,380,S,3865,4209,8074,0.0008
Mesorhizobium loti,381,S,863,882,1745,0.00017
Sinorhizobium meliloti,382,S,2224,625,2849,0.00028
Leuconostoc carnosum,1252,S,171,17,188,0.00002
Rhizobium leguminosarum,384,S,5517,818,6335,0.00062
Azoarcus sp. KH32C,748247,S,1339,56,1395,0.00014
Antarctobacter heliothermus,74033,S,629,31,660,0.00007
Pseudoalteromonas tunicata,314281,S,70,2,72,0.00001
Psychromonas sp. CNPT3,314282,S,51,6,57,0.00001
Hymenobacter sedentarius,1411621,S,128,9,137,0.00001
Pseudoalteromonas piratica,1348114,S,35,3,38,0
Bosea vaviloviae,1526658,S,5976,1343,7319,0.00072
Acaryochloris marina,155978,S,47,1,48,0
Dickeya fangzhongdai,1778540,S,67,38,105,0.00001
Leptolyngbya sp. O-77,1080068,S,72,2,74,0.00001
Xanthomonas vasicola,56459,S,693,92,785,0.00008
Xanthomonas sacchari,56458,S,3752,1160,4912,0.00048
Bacillus wiedmannii,1890302,S,38,1,39,0
Xanthomonas hortorum,56454,S,473,467,940,0.00009
Serratia rubidaea,61652,S,153,111,264,0.00003
Thermaerobacter marianensis,73919,S,174,0,174,0.00002
Xanthomonas cassavae,56450,S,1331,243,1574,0.00016
Lentibacillus amyloliquefaciens,1472767,S,48,1,49,0
Thioalkalivibrio nitratireducens,186931,S,214,70,284,0.00003
Saccharomonospora marina,632569,S,202,64,266,0.00003
Acinetobacter sp. SWBY1,2079596,S,30760,2858,33618,0.00331
Roseovarius mucosus,215743,S,161,283,444,0.00004
Advenella mimigardefordensis,302406,S,392,40,432,0.00004
Bacillus pseudomycoides,64104,S,32,1,33,0
Streptomyces autolyticus,75293,S,16,12,28,0
Shewanella sp. MR-7,60481,S,55,26,81,0.00001
Shewanella sp. MR-4,60480,S,39,20,59,0.00001
Acholeplasma palmae,38986,S,26,1,27,0
Candidatus Filomicrobium marinum,1608628,S,77,2,79,0.00001
Methanoculleus marisnigri,2198,S,18,1,19,0
Mannheimia haemolytica,75985,S,146,31,177,0.00002
Myroides odoratus,256,S,223,3,226,0.00002
Polynucleobacter wuianus,1743168,S,36,9,45,0
Photobacterium profundum,74109,S,81,2,83,0.00001
Escherichia virus VR26,1913686,S,23,15,38,0
Methanofollis liminatans,2201,S,23,3,26,0
Pseudonocardia dioxanivorans,240495,S,406,69,475,0.00005
Methanospirillum hungatei,2203,S,506,21,527,0.00005
Prevotella jejuni,1177574,S,98,56,154,0.00002
Methanosarcina barkeri,2208,S,263,6,269,0.00003
Runella slithyformis,106,S,139,10,149,0.00001
Escherichia virus VR20,1913684,S,17,9,26,0
Enterobacter virus PG7,1913655,S,50,6,56,0.00001
Rhodobaca barguzinensis,441209,S,741,20,761,0.00008
Lactobacillus gallinarum,52242,S,101,39,140,0.00001
Agarilytica rhodophyticola,1737490,S,34,0,34,0
Thermosipho africanus,2421,S,25,15,40,0
Desulfovibrio sp. FW1012B,644968,S,1562,21,1583,0.00016
Teredinibacter turnerae,2426,S,136,3,139,0.00001
Sphingobacterium sp. ML3W,1538644,S,334,25,359,0.00004
Chryseobacterium sp. StRB126,878220,S,685,313,998,0.0001
Bordetella bronchialis,463025,S,821,62,883,0.00009
Bordetella genomosp. 6,463024,S,110,127,237,0.00002
Pseudomonas sp. TKP,1415630,S,129,298,427,0.00004
Nakamurella panacisegetis,1090615,S,252,13,265,0.00003
Desulfovibrio hydrothermalis,191026,S,51,0,51,0.00001
Oleiphilus messinensis,141451,S,103,8,111,0.00001
Megasphaera elsdenii,907,S,3145,475,3620,0.00036
Rhodothermaceae bacterium,2026787,S,68,67,135,0.00001
Oligella urethralis,90245,S,1059,20,1079,0.00011
Alkaliphilus oremlandii,461876,S,62,3,65,0.00001
Aeromicrobium erythreum,2041,S,398,85,483,0.00005
Bacillus sp. 1NLA3E,666686,S,182,10,192,0.00002
Cronobacter dublinensis,413497,S,260,25,285,0.00003
Rhodanobacter denitrificans,666685,S,1405,320,1725,0.00017
Streptococcus sp. Z15,2173853,S,502,3,505,0.00005
Acidovorax carolinensis,553814,S,129136,50830,179966,0.01774
Streptomyces vietnamensis,362257,S,138,17,155,0.00002
Campylobacter peloridis,488546,S,18,0,18,0
Symbiobacterium thermophilum,2734,S,218,0,218,0.00002
Thermoanaerobacterium xylanolyticum,29329,S,40,18,58,0.00001
Dickeya zeae,204042,S,293,9,302,0.00003
Lactococcus virus CB13,665883,S,120,40,160,0.00002
Corynebacterium argentoratense,42817,S,103,7,110,0.00001
Shigella phage SHBML-50-1,1863007,S,12,53,65,0.00001
Caulobacter vibrioides,155892,S,1439,453,1892,0.00019
Bacillus gobiensis,1441095,S,43,1,44,0
Pseudoxanthomonas suwonensis,314722,S,35480,9662,45142,0.00445
Roseiflexus castenholzii,120962,S,99,15,114,0.00001
Pseudomonas psychrotolerans,237610,S,557,15,572,0.00006
Lactobacillus phage LfeInf,1567484,S,17,0,17,0
Gordonia phage GMA4,1647471,S,14,0,14,0
Blastococcus saxobsidens,138336,S,368,60,428,0.00004
Nocardia soli,134962,S,390,69,459,0.00005
Amycolatopsis methanolica,1814,S,281,63,344,0.00003
Acidithiobacillus caldus,33059,S,833,63,896,0.00009
Acetobacter ascendens,481146,S,68,44,112,0.00001
Paraburkholderia phytofirmans,261302,S,319,99,418,0.00004
methanogenic archaeon ISO4-H5,1495144,S,14,3,17,0
Sphingopyxis macrogoltabida,33050,S,7852,2190,10042,0.00099
Reinekea forsetii,1336806,S,138,1,139,0.00001
Sphingopyxis terrae,33052,S,4940,1184,6124,0.0006
Sphingobium sp. YBL2,484429,S,837,339,1176,0.00012
Candidatus Kinetoplastibacterium crithidii,33056,S,13,-13,0,0
Gordonia rubripertincta,36822,S,897,360,1257,0.00012
Vibrio mimicus,674,S,53,6,59,0.00001
Lacinutrix sp. 5H-3-7-4,983544,S,76,21,97,0.00001
Sulfurifustis variabilis,1675686,S,295,7,302,0.00003
Escherichia virus CC31,1913656,S,34,4,38,0
Mycobacterium sp. QIA-37,1561223,S,157,837,994,0.0001
Pseudomonas sp. StFLB209,1028989,S,914,41,955,0.00009
Flavivirga eckloniae,1803846,S,126,4,130,0.00001
Streptomyces sp. 11-1-2,1851167,S,16,9,25,0
Pseudomonas sp. LPH1,1898684,S,430,104,534,0.00005
Streptomyces griseorubiginosus,67304,S,96,8,104,0.00001
Echinicola vietnamensis,390884,S,41,12,53,0.00001
Salinimonas sp. N102,2303538,S,73,6,79,0.00001
Chloroflexus aggregans,152260,S,37,7,44,0
Echinicola strongylocentroti,1795355,S,41,3,44,0
[Clostridium] cellulosi,29343,S,183,6,189,0.00002
Hyphomicrobium sp. MC1,717785,S,271,14,285,0.00003
Clostridium argentinense,29341,S,185,1,186,0.00002
Allokutzneria albata,211114,S,287,49,336,0.00003
Acinetobacter bereziniae,106648,S,2278,29,2307,0.00023
Helicobacter bilis,37372,S,23,2,25,0
Nostoc sp. CENA543,1869241,S,10,1,11,0
Burkholderiales bacterium JOSHI_001,864051,S,4602,439,5041,0.0005
Lactobacillus agilis,1601,S,294,18,312,0.00003
Hydrogenovibrio crunogenus,39765,S,37,0,37,0
Sulfurimonas denitrificans,39766,S,138,3,141,0.00001
Lactobacillus alimentarius,1602,S,119,5,124,0.00001
Thermosediminibacter oceani,291990,S,61,1,62,0.00001
Candidatus Babela massiliensis,673862,S,23,0,23,0
Streptomyces noursei,1971,S,44,9,53,0.00001
Olsenella umbonata,604330,S,878,101,979,0.0001
Streptomyces parvulus,146923,S,120,16,136,0.00001
Candidatus Pelagibacter sp. RS40,1977865,S,20,1,21,0
Streptomyces venezuelae,54571,S,260,29,289,0.00003
Bartonella quintana,803,S,11,5,16,0
Burkholderia sp. PAMC 28687,1795874,S,110,119,229,0.00002
Pseudomonas sp. FGI182,1259844,S,93,82,175,0.00002
Pectobacterium polaris,2042057,S,167,65,232,0.00002
Photorhabdus thracensis,230089,S,77,51,128,0.00001
Synechococcus sp. RCC307,316278,S,49,4,53,0.00001
Erythrobacter sp. KY5,2011159,S,237,8,245,0.00002
Burkholderia seminalis,488731,S,99,46,145,0.00001
Sphingobium sp. YG1,2082188,S,1323,353,1676,0.00017
Syntrophus aciditrophicus,316277,S,184,0,184,0.00002
Virgibacillus phasianinus,2017483,S,45,1,46,0
Pseudomonas asplenii,53407,S,230,119,349,0.00003
Flavobacterium sp. HYN0056,2183896,S,535,71,606,0.00006
Brachybacterium sp. VR2415,2017485,S,179,84,263,0.00003
Pseudomonas oryzae,1392877,S,896,56,952,0.00009
Francisella sp. FSC1006,1547445,S,14,0,14,0
Kocuria palustris,71999,S,636,137,773,0.00008
Sediminispirochaeta smaragdinae,55206,S,65,0,65,0.00001
Mycobacteroides chelonae,1774,S,567,1472,2039,0.0002
Bifidobacterium actinocoloniiforme,638619,S,167,0,167,0.00002
Mycolicibacterium phlei,1771,S,1204,413,1617,0.00016
Desulfotomaculum ferrireducens,1833852,S,156,24,180,0.00002
Mycobacterium tuberculosis,1773,S,33,3497,3530,0.00035
Mycolicibacterium smegmatis,1772,S,1575,505,2080,0.00021
Kocuria turfanensis,388357,S,378,42,420,0.00004
Pseudomonas cedrina,651740,S,1012,196,1208,0.00012
Pseudomonas sp. PONIH3,1636610,S,113,278,391,0.00004
Exiguobacterium oxidotolerans,223958,S,20,1,21,0
Corynebacterium deserti,1408191,S,161,20,181,0.00002
Rhodobacteraceae bacterium BAR1,2171755,S,414,9,423,0.00004
Leptotrichia buccalis,40542,S,990,279,1269,0.00013
Leuconostoc suionicum,1511761,S,42,7,49,0
Campylobacter hominis,76517,S,46,1,47,0
Klebsiella sp. M5al,1934254,S,2593,5083,7676,0.00076
Cronobacter virus GAP31,1914895,S,51,6,57,0.00001
Enterococcus thailandicus,417368,S,256,23,279,0.00003
Pseudomonas sp. Z003-0.4C(8344-21),1855380,S,370,174,544,0.00005
Burkholderia anthina,179879,S,98,54,152,0.00001
Cycloclasticus sp. PY97N,728003,S,27,15,42,0
Roseomonas gilardii,257708,S,5492,440,5932,0.00058
Corynebacterium genitalium,38288,S,121,6,127,0.00001
Corynebacterium jeikeium,38289,S,362,237,599,0.00006
Cronobacter virus CR9,1914899,S,18,6,24,0
Olsenella sp. Marseille-P2300,1805478,S,1321,73,1394,0.00014
Defluviitoga tunisiensis,1006576,S,28,8,36,0
Cupriavidus sp. USMAA1020,367825,S,74,431,505,0.00005
Arthrobacter sp. DCT5,2211210,S,192,11,203,0.00002
Agrococcus jejuensis,399736,S,582,91,673,0.00007
Gottschalkia acidurici,1556,S,311,1,312,0.00003
Steroidobacter denitrificans,465721,S,929,59,988,0.0001
Pedobacter ginsengisoli,363852,S,71,9,80,0.00001
Chondromyces crocatus,52,S,205,7,212,0.00002
Polaromonas naphthalenivorans,216465,S,7872,678,8550,0.00084
Chromobacterium violaceum,536,S,465,200,665,0.00007
Plantactinospora sp. BB1,2071627,S,41,98,139,0.00001
Streptomyces olivoreticuli,68246,S,143,16,159,0.00002
Cedecea neteri,158822,S,1251,38,1289,0.00013
Streptomyces sp. SAT1,1849967,S,110,15,125,0.00001
Sagittula sp. P11,2009329,S,1247,1363,2610,0.00026
Chitinophaga pinensis,79329,S,46,9,55,0.00001
Spiroplasma phoeniceum,47835,S,10,38,48,0
Sphingobium sp. SCG-1,2072936,S,604,10,614,0.00006
Actinobacillus porcitonsillarum,189834,S,131,20,151,0.00001
Streptomyces pactum,68249,S,173,21,194,0.00002
Eikenella corrodens,539,S,2869,1401,4270,0.00042
Tistrella mobilis,171437,S,700,106,806,0.00008
Campylobacter lari,201,S,56,1,57,0.00001
Sorangium cellulosum,56,S,759,54,813,0.00008
Lysinibacillus sp. YS11,2072025,S,37,9,46,0
Planctomyces sp. SH-PL14,1632864,S,226,13,239,0.00002
Salinisphaera sp. LB1,2183911,S,258,0,258,0.00003
Limnobaculum parvum,2172103,S,68,0,68,0.00001
Polynucleobacter acidiphobus,556053,S,202,5,207,0.00002
Pontibacter korlensis,400092,S,80,14,94,0.00001
Novosphingobium aromaticivorans,48935,S,1088,101,1189,0.00012
Polynucleobacter difficilis,556054,S,301,20,321,0.00003
Sphingobium baderi,1332080,S,1316,1152,2468,0.00024
Legionella waltersii,66969,S,28,11,39,0
Lactococcus phage WRP3,1560313,S,72,62,134,0.00001
Cyanothece sp. PCC 7425,395961,S,28,1,29,0
Tumebacillus algifaecis,1214604,S,59,21,80,0.00001
Janthinobacterium sp. B9-8,1236179,S,301,13,314,0.00003
Geobacter metallireducens,28232,S,123,3,126,0.00001
Streptomyces coelicolor,1902,S,30,48,78,0.00001
Mycobacterium sp. djl-10,1879023,S,1687,93,1780,0.00018
Thiomicrospira aerophila,92245,S,85,11,96,0.00001
Achromobacter spanius,217203,S,1931,337,2268,0.00022
Denitrobacterium detoxificans,79604,S,242,18,260,0.00003
Lactococcus virus 712,213769,S,60,19,79,0.00001
Clostridium chauvoei,46867,S,211,3,214,0.00002
Achromobacter insolitus,217204,S,1097,158,1255,0.00012
Francisella sp. CA97-1460,1542390,S,18,0,18,0
Methylomonas methanica,421,S,217,3,220,0.00002
Beijerinckia indica,533,S,257,9,266,0.00003
Faecalitalea cylindroides,39483,S,9247,1654,10901,0.00107
[Eubacterium] eligens,39485,S,12754,360,13114,0.00129
Escherichia albertii,208962,S,571,70,641,0.00006
Corynebacterium halotolerans,225326,S,155,9,164,0.00002
Methylosinus trichosporium,426,S,625,65,690,0.00007
Synechococcus sp. JA-3-3Ab,321327,S,59,59,118,0.00001
Paenibacillus sp. RUD330,2023772,S,127,15,142,0.00001
Laceyella sp. FBKL4.010,2071623,S,103,1,104,0.00001
Altererythrobacter marensis,543877,S,463,35,498,0.00005
Mesoplasma tabanidae,219745,S,13,11,24,0
Synechococcus lividus,33070,S,32,4,36,0
Pseudoflavitalea sp. 5GH32-13,2315862,S,91,9,100,0.00001
Pandoraea faecigallinarum,656179,S,468,113,581,0.00006
Pandoraea vervacti,656178,S,504,141,645,0.00006
Gramella flava,1486245,S,63,15,78,0.00001
Haemophilus sp. oral taxon 036,712310,S,29,6,35,0
Xanthomonas euvesicatoria,456327,S,376,2630,3006,0.0003
Pseudomonas sp. CC6-YY-74,1930532,S,890,23,913,0.00009
Bradyrhizobium ottawaense,931866,S,442,1647,2089,0.00021
Intestinimonas butyriciproducens,1297617,S,4867,210,5077,0.0005
blood disease bacterium A2-HR MARDI,1944648,S,38,48,86,0.00001
Ensifer sojae,716925,S,921,600,1521,0.00015
Sanguibacter keddieii,60920,S,528,79,607,0.00006
Acidobacterium capsulatum,33075,S,100,7,107,0.00001
Sphingorhabdus sp. YGSMI21,2077182,S,270,40,310,0.00003
Geosporobacter ferrireducens,1424294,S,391,5,396,0.00004
Corynebacterium efficiens,152794,S,184,10,194,0.00002
Mesorhizobium japonicum,2066070,S,417,226,643,0.00006
Lutibacter sp. LPB0138,1850246,S,190,39,229,0.00002
Achromobacter sp. B7,2282475,S,898,88,986,0.0001
Staphylococcus lutrae,155085,S,30,1,31,0
Desulfovibrio sp. G11,631220,S,4398,5847,10245,0.00101
Candidatus Enterovibrio luxaltus,1927128,S,16,0,16,0
Vulgatibacter incomptus,1391653,S,150,7,157,0.00002
Treponema caldarium,215591,S,68,0,68,0.00001
Pseudomonas sp. MRSN12121,1611770,S,248,271,519,0.00005
Geobacillus stearothermophilus,1422,S,43,144,187,0.00002
Bacteroides phage B40-8,99179,S,34,3,37,0
Flammeovirga sp. MY04,1191459,S,110,4,114,0.00001
Sphingomonas sanxanigenens,397260,S,1508,319,1827,0.00018
Human mastadenovirus F,130309,S,31,0,31,0
Candidatus Planktophila sulfonica,1884904,S,67,14,81,0.00001
Hungateiclostridium saccincola,1677857,S,99,17,116,0.00001
Methylomonas sp. DH-1,1727196,S,98,75,173,0.00002
Mycobacterium sp. EPa45,1545728,S,1041,45,1086,0.00011
Arthrobacter sp. ZXY-2,1806905,S,87,224,311,0.00003
Listeria innocua,1642,S,80,7,87,0.00001
Flavobacterium faecale,1355330,S,543,23,566,0.00006
Colwellia sp. PAMC 20917,1816218,S,57,2,59,0.00001
Colwellia sp. PAMC 21821,1816219,S,20,6,26,0
Barnesiella viscericola,397865,S,256,48,304,0.00003
Celeribacter baekdonensis,875171,S,414,245,659,0.00006
Thermoanaerobacterium sp. RBIITD,1550240,S,57,32,89,0.00001
Xanthomonas arboricola,56448,S,615,241,856,0.00008
Lactobacillus rhamnosus,47715,S,418,32,450,0.00004
secondary endosymbiont of Ctenarytaina eucalypti,1199245,S,25,0,25,0
Melittangium boletus,83453,S,150,65,215,0.00002
Synechococcus sp. CC9605,110662,S,22,12,34,0
Tumebacillus avium,1903704,S,99,29,128,0.00001
Gordonia phthalatica,1136941,S,3336,952,4288,0.00042
Pseudomonas sp. VLB120,69328,S,61,291,352,0.00003
Methanomethylovorans hollandica,101192,S,219,1,220,0.00002
Nonomuraea sp. ATCC 55076,1909395,S,450,47,497,0.00005
Brucella pinnipedialis,120576,S,12,511,523,0.00005
Idiomarina loihiensis,135577,S,94,-94,0,0
Corynebacterium singulare,161899,S,90,16,106,0.00001
Pseudomonas syringae group genomosp. 3,251701,S,614,486,1100,0.00011
Pseudomonas sp. R2A2,2213057,S,341,51,392,0.00004
Mariniflexile sp. TRM1-10,2027857,S,201,5,206,0.00002
Pseudoalteromonas haloplanktis,228,S,27,152,179,0.00002
Pseudoalteromonas carrageenovora,227,S,51,11,62,0.00001
Pelosinus fermentans,365349,S,203,98,301,0.00003
Treponema primitia,88058,S,76,0,76,0.00001
Methanosarcina thermophila,2210,S,13,0,13,0
Burkholderia lata,482957,S,267,130,397,0.00004
Methanosarcina vacuolata,2215,S,21,38,59,0.00001
Thioalkalivibrio sp. K90mix,396595,S,213,18,231,0.00002
Paraburkholderia terrae,311230,S,168,126,294,0.00003
Edwardsiella hoshinae,93378,S,93,3,96,0.00001
Enterobacter cancerogenus,69218,S,784,33,817,0.00008
Roseibacterium elongatum,159346,S,674,46,720,0.00007
Deinococcus maricopensis,309887,S,80,2,82,0.00001
Actinobacteria bacterium IMCC19121,1848754,S,10,3,13,0
Cupriavidus gilardii,82541,S,964,384,1348,0.00013
Edwardsiella ictaluri,67780,S,180,21,201,0.00002
Alteromonas sp. RKMC-009,2267264,S,51,2,53,0.00001
Spirochaeta thermophila,154,S,88,0,88,0.00001
Acinetobacter sp. NCu2D-2,1608473,S,2076,92,2168,0.00021
Brachyspira hyodysenteriae,159,S,26,7,33,0
Staphylococcus equorum,246432,S,35,24,59,0.00001
Bacillus cytotoxicus,580165,S,74,3,77,0.00001
Roseobacter denitrificans,2434,S,252,49,301,0.00003
Planococcus versutus,1302659,S,18,2,20,0
Synechococcus sp. PCC 7336,195250,S,39,0,39,0
Azoarcus communis,41977,S,6552,1015,7567,0.00075
Acidovorax sp. KKS102,358220,S,226930,59945,286875,0.02827
Alcanivorax sp. NBRC 101098,1113728,S,23,84,107,0.00001
Halobacillus halophilus,1570,S,46,3,49,0
Shewanella japonica,93973,S,47,0,47,0
Actinomyces sp. 2129,2321394,S,128,3,131,0.00001
Desulfobacter postgatei,2293,S,144,8,152,0.00001
Klebsiella sp. LTGPAF-6F,1905288,S,29,641,670,0.00007
Plantibacter flavus,150123,S,541,60,601,0.00006
Geobacter lovleyi,313985,S,329,12,341,0.00003
Paludisphaera borealis,1387353,S,287,22,309,0.00003
Gemella sp. oral taxon 928,1785995,S,31,62,93,0.00001
Candidatus Moranella endobia,1048758,S,14,-14,0,0
Xanthomonas gardneri,90270,S,277,1266,1543,0.00015
Pseudomonas mucidolens,46679,S,1109,89,1198,0.00012
Acetobacter tropicalis,104102,S,31,23,54,0.00001
Gemella sp. ND 6198,2040624,S,10,24,34,0
Vagococcus penaei,633807,S,451,49,500,0.00005
Brachyspira pilosicoli,52584,S,30,0,30,0
Pseudomonas agarici,46677,S,765,13,778,0.00008
Haloarculaceae archaeon HArcel1,1679096,S,16,0,16,0
Rahnella sp. ERMR1:05,1805933,S,556,14,570,0.00006
Hirschia baltica,2724,S,36,0,36,0
Homo sapiens,9606,S,144235,713,144948,0.01429
Desulfitobacterium hafniense,49338,S,293,34,327,0.00003
Colwellia sp. MT41,58049,S,44,2,46,0
Streptococcus halotolerans,1814128,S,2047,32,2079,0.0002
Methyloversatilis sp. RAC08,1842540,S,1295,70,1365,0.00013
Ruminococcaceae bacterium CPB6,1572656,S,820,12,832,0.00008
Candidatus Symbiobacter mobilis,1436290,S,1036,10,1046,0.0001
Congregibacter litoralis,393662,S,160,12,172,0.00002
Gemmobacter sp. HYN0069,2169400,S,2599,252,2851,0.00028
Conexibacter woesei,191495,S,315,3,318,0.00003
Mycolicibacterium chubuense,1800,S,1316,171,1487,0.00015
Dietzia lutea,546160,S,341,124,465,0.00005
Candidatus Hamiltonella defensa,138072,S,141,1,142,0.00001
Mycobacterium paraintracellulare,1138383,S,20,48,68,0.00001
Xanthomonas citri phage CP2,1188795,S,84,0,84,0.00001
Parvimonas micra,33033,S,263,26,289,0.00003
Shewanella amazonensis,60478,S,161,3,164,0.00002
Variovorax paradoxus,34073,S,14158,3038,17196,0.00169
Clostridiales bacterium CCNA10,2109688,S,11103,1229,12332,0.00122
Burkholderia latens,488446,S,33,76,109,0.00001
Burkholderia contaminans,488447,S,198,103,301,0.00003
Acetomicrobium mobile,97477,S,53,1,54,0.00001
Lactobacillus mucosae,97478,S,3311,131,3442,0.00034
Fervidobacterium islandicum,2423,S,24,7,31,0
Mycolicibacterium rhodesiae,36814,S,1227,211,1438,0.00014
Oscillibacter sp. PEA192,2109687,S,5498,658,6156,0.00061
Olsenella sp. GAM18,2109685,S,4998,323,5321,0.00052
Lactobacillus paracollinoides,240427,S,140,13,153,0.00002
Micromonospora narathiwatensis,299146,S,97,35,132,0.00001
Candidatus Fonsibacter ubiquis,1925548,S,153,13,166,0.00002
Mucilaginibacter sp. BJC16-A31,1234841,S,28,4,32,0
Campylobacter hepaticus,1813019,S,14,0,14,0
Auritidibacter sp. NML130574,2170745,S,269,14,283,0.00003
Bosea sp. PAMC 26642,1792307,S,4084,829,4913,0.00048
Streptomyces sp. S8,1837283,S,38,21,59,0.00001
Arthrobacter sp. PAMC 25486,1494608,S,132,8,140,0.00001
Mycobacterium virus Patience,1982360,S,14,0,14,0
Escherichia virus HY01,2049937,S,11,19,30,0
Corynebacterium doosanense,1121358,S,212,33,245,0.00002
Blattabacterium punctulatus,164514,S,21,61,82,0.00001
[Eubacterium] hallii,39488,S,29829,1512,31341,0.00309
Clostridium sp. MF28,1702238,S,13,2,15,0
Streptomyces albireticuli,1940,S,116,14,130,0.00001
Bacillus sp. FJAT-18017,1705566,S,32,1,33,0
Candidatus Solibacter usitatus,332163,S,162,0,162,0.00002
Bacteroides thetaiotaomicron,818,S,1673,114,1787,0.00018
Scardovia inopinata,78259,S,67,0,67,0.00001
Selenomonas sp. oral taxon 126,712528,S,155,14,169,0.00002
Vibrio azureus,512649,S,34,1,35,0
Prevotella scopos,589437,S,107,96,203,0.00002
Clostridium beijerinckii,1520,S,230,9,239,0.00002
Nonlabens marinus,930802,S,73,44,117,0.00001
Lactococcus phage jm2,1262535,S,178,48,226,0.00002
Lactococcus phage jm3,1262536,S,96,35,131,0.00001
Bacteroides fragilis,817,S,2819,265,3084,0.0003
Arthrobacter sp. FB24,290399,S,216,28,244,0.00002
Calditerrivibrio nitroreducens,477976,S,39,0,39,0
Marinomonas primoryensis,178399,S,79,6,85,0.00001
Lysobacter antibioticus,84531,S,3410,1189,4599,0.00045
Klebsiella phage K64-1,1439894,S,20,16,36,0
Acinetobacter indicus,756892,S,3282,224,3506,0.00035
Pseudomonas reinekei,395598,S,794,70,864,0.00009
Limnohabitans sp. 63ED37-2,1678128,S,8179,530,8709,0.00086
Limnohabitans sp. 103DPR2,1678129,S,3166,147,3313,0.00033
Leptotrichia sp. oral taxon 212,712357,S,1549,266,1815,0.00018
Cyclobacterium amurskyense,320787,S,29,0,29,0
Clostridium botulinum,1491,S,1432,28,1460,0.00014
Clostridium butyricum,1492,S,645,3,648,0.00006
Clostridium cellulovorans,1493,S,190,2,192,0.00002
Pseudomonas resinovorans,53412,S,908,50,958,0.00009
Hymenobacter swuensis,1446467,S,64,11,75,0.00001
Clostridioides difficile,1496,S,14871,1861,16732,0.00165
Clostridium formicaceticum,1497,S,153,4,157,0.00002
Frankia alni,1859,S,161,96,257,0.00003
Capnocytophaga sp. H4358,1945658,S,13,48,61,0.00001
Hymenobacter sp. APR13,1356852,S,82,18,100,0.00001
Weissella soli,155866,S,224,9,233,0.00002
Streptomyces lunaelactis,1535768,S,164,13,177,0.00002
Corynebacterium stationis,1705,S,73,6,79,0.00001
Methanothermococcus okinawensis,155863,S,13,4,17,0
Cellulomonas fimi,1708,S,534,127,661,0.00007
Brevibacillus brevis,1393,S,213,56,269,0.00003
Bacillus anthracis,1392,S,18,346,364,0.00004
Natronococcus occultus,29288,S,24,1,25,0
Helicobacter canadensis,123841,S,15,0,15,0
Achromobacter phage JWAlpha,1416009,S,16,0,16,0
Candidatus Desulfofervidus auxilii,1621989,S,34,0,34,0
Salmonella virus 118970sal2,1982565,S,31,-31,0,0
Corynebacterium humireducens,1223514,S,171,13,184,0.00002
Enterobacter sp. SA187,1914861,S,767,16,783,0.00008
Candidatus Aquiluna sp. UB-MaderosW2red,1855377,S,37,4,41,0
Halorubrum trapanicum,29284,S,24,3,27,0
Methylorubrum populi,223967,S,1398,465,1863,0.00018
Coriobacteriaceae bacterium 68-1-3,1531429,S,297,45,342,0.00003
Cronobacter condimenti,1163710,S,298,20,318,0.00003
Deinococcus gobiensis,502394,S,124,8,132,0.00001
Aeromonas sp. CA23,2033032,S,471,34,505,0.00005
Aeromonas sp. CU5,2033033,S,478,29,507,0.00005
Dyella japonica,231455,S,786,187,973,0.0001
Streptococcus himalayensis,1888195,S,1493,52,1545,0.00015
Lactococcus phage TP901-1,35345,S,14,8,22,0
Aeromonas phage vB_AsaM-56,1127514,S,876,0,876,0.00009
Azospira oryzae,146939,S,5551,550,6101,0.0006
Acetobacterium woodii,33952,S,984,61,1045,0.0001
Vibrio breoganii,553239,S,58,1,59,0.00001
Lactobacillus johnsonii,33959,S,1472,99,1571,0.00015
Escherichia phage phAPEC8,1229753,S,178,0,178,0.00002
Halanaerobium hydrogeniformans,656519,S,37,28,65,0.00001
Gordonibacter urolithinfaciens,1335613,S,1592,286,1878,0.00019
Mycobacterium phage Myrna,546805,S,17,0,17,0
Streptomyces sp. WAC00288,2094021,S,116,17,133,0.00001
Rhodocyclaceae bacterium,1898103,S,298,765,1063,0.0001
Aureitalea sp. RR4-38,2094025,S,62,1,63,0.00001
Acidiphilium cryptum,524,S,68,176,244,0.00002
Vibrio hyugaensis,1534743,S,35,18,53,0.00001
Enterobacter hormaechei,158836,S,3208,21934,25142,0.00248
Bordetella pertussis,520,S,44,362,406,0.00004
Acinetobacter soli,487316,S,2863,74,2937,0.00029
Weeksella virosa,1014,S,1015,38,1053,0.0001
Sphingomonas sp. JJ-A5,1921510,S,450,318,768,0.00008
Deinococcus sp. NW-56,2080419,S,69,6,75,0.00001
Burkholderia sp. CCGE1003,640512,S,283,70,353,0.00003
Ochrobactrum anthropi,529,S,6068,8255,14323,0.00141
Burkholderia sp. CCGE1001,640510,S,123,865,988,0.0001
Burkholderia sp. CCGE1002,640511,S,309,74,383,0.00004
Acetobacter oryzifermentans,1633874,S,12,42,54,0.00001
Sulfuriferula sp. AH1,1985873,S,518,47,565,0.00006
Lysobacter gummosus,262324,S,2376,1234,3610,0.00036
Dokdonia sp. PRO95,1239415,S,41,10,51,0.00001
Stanieria sp. NIES-3757,1807358,S,20,2,22,0
Flavobacteriaceae bacterium,1871037,S,97,5,102,0.00001
Corynebacterium lactis,1231000,S,94,4,98,0.00001
Kangiella sediminilitoris,1144748,S,55,1,56,0.00001
Propionimicrobium sp. Marseille-P3275,1871034,S,125,18,143,0.00001
Piscirickettsia salmonis,1238,S,38,0,38,0
Cloacibacillus porcorum,1197717,S,1447,30,1477,0.00015
Bifidobacterium scardovii,158787,S,536,9,545,0.00005
Jonesia denitrificans,43674,S,224,17,241,0.00002
Candidatus Puniceispirillum marinum,767892,S,36,0,36,0
Sneathia amnii,187101,S,378,17,395,0.00004
Glutamicibacter arilaitensis,256701,S,478,105,583,0.00006
Enterococcus gilvus,160453,S,2511,212,2723,0.00027
Candidatus Arsenophonus lipoptenae,634113,S,26,0,26,0
Brachyspira murdochii,84378,S,36,8,44,0
Lactococcus phage 949,881953,S,66,5,71,0.00001
Bacillus halodurans,86665,S,64,1,65,0.00001
Bacillus flexus,86664,S,70,4,74,0.00001
Alcanivorax xenomutans,1094342,S,185,18,203,0.00002
Legionella sainthelensi,28087,S,37,16,53,0.00001
Bifidobacterium kashiwanohense,630129,S,8462,1789,10251,0.00101
Owenweeksia hongkongensis,253245,S,64,0,64,0.00001
Legionella anisa,28082,S,29,5,34,0
Acetobacter pasteurianus,438,S,157,397,554,0.00005
Escherichia virus phiEco32,490103,S,24,8,32,0
Komagataeibacter hansenii,436,S,94,8,102,0.00001
Solibacillus silvestris,76853,S,103,20,123,0.00001
Acetobacter aceti,435,S,126,5,131,0.00001
Massilia timonae,47229,S,930,105,1035,0.0001
Corynebacterium ulcerans,65058,S,40,3,43,0
Frankia casuarinae,106370,S,152,16,168,0.00002
Curtobacterium sp. MR_MD2014,1561023,S,313,102,415,0.00004
Escherichia phage PBECO 4,1273738,S,21,11,32,0
Acinetobacter sp. TGL-Y2,1407071,S,1695,27,1722,0.00017
Lactococcus phage P087,641487,S,73,0,73,0.00001
Methanobrevibacter millerae,230361,S,71,0,71,0.00001
Actinomyces gaoshouyii,1960083,S,119,64,183,0.00002
Celeribacter indicus,1208324,S,1595,1561,3156,0.00031
Actinoalloteichus hoggarensis,1470176,S,172,149,321,0.00003
Blattabacterium sp. (Blattella germanica),624186,S,17,2,19,0
Pandoraea apista,93218,S,693,171,864,0.00009
Pandoraea norimbergensis,93219,S,670,70,740,0.00007
Thermovibrio ammonificans,228745,S,12,1,13,0
Pseudomonas alcaliphila,101564,S,590,344,934,0.00009
Aminobacterium colombiense,81468,S,70,2,72,0.00001
Hymenobacter sp. DG25A,1385663,S,35,32,67,0.00001
Halomonas beimenensis,475662,S,281,13,294,0.00003
Bacillus xiamenensis,1178537,S,23,1,24,0
Providencia heimbachae,333962,S,64,3,67,0.00001
Rhodobacter sp. LPB0142,1850250,S,3704,1455,5159,0.00051
Citrobacter freundii complex sp. CFNIH2,2066049,S,157,135,292,0.00003
Arcobacter sp. LPB0137,1850254,S,536,17,553,0.00005
Cellvibrio japonicus,155077,S,157,9,166,0.00002
Microbacterium sp. PM5,2014534,S,2663,341,3004,0.0003
Formosa sp. Hel1_31_208,1798225,S,96,5,101,0.00001
Methylobacterium sp. C1,1479019,S,153,565,718,0.00007
Myroides sp. A21,1583100,S,24,16,40,0
Azospirillum humicireducens,1226968,S,302,215,517,0.00005
Agrobacterium sp. H13-3,861208,S,158,545,703,0.00007
Massilia putida,1141883,S,853,237,1090,0.00011
Methylovorus glucosotrophus,266009,S,90,75,165,0.00002
Salmonella virus Stitch,1540099,S,32,41,73,0.00001
Mycobacterium virus Brujita,561996,S,16,16,32,0
Mucilaginibacter gotjawali,1550579,S,53,5,58,0.00001
Amycolatopsis orientalis,31958,S,189,154,343,0.00003
Thalassospira marina,2048283,S,156,6,162,0.00002
Halorubrum lacusprofundi,2247,S,20,17,37,0
Myroides odoratimimus,76832,S,245,356,601,0.00006
Yersinia aleksiciae,263819,S,114,10,124,0.00001
Thalassospira xiamenensis,220697,S,328,10,338,0.00003
Porphyrobacter sp. CACIAM 03H1,2003315,S,1201,262,1463,0.00014
Butyrivibrio proteoclasticus,43305,S,402,126,528,0.00005
Pseudarthrobacter phenanthrenivorans,361575,S,469,131,600,0.00006
Herminiimonas arsenitoxidans,1809410,S,267,32,299,0.00003
Flavobacterium gilvum,1492737,S,790,38,828,0.00008
Kyrpidia spormannii,2055160,S,35,6,41,0
Erythrobacter seohaensis,266951,S,273,23,296,0.00003
Escherichia virus 4MG,1914894,S,48,12,60,0.00001
Streptomyces sp. ZFG47,2184053,S,140,12,152,0.00001
Methanosphaerula palustris,475088,S,96,8,104,0.00001
Halanaeroarchaeum sulfurireducens,1604004,S,23,1,24,0
Calothrix parietina,32054,S,16,2,18,0
Tolumonas auensis,43948,S,2098,106,2204,0.00022
Synechococcus sp. WH 7803,32051,S,34,8,42,0
Helicobacter bizzozeronii,56877,S,34,1,35,0
Komagataeibacter xylinus,28448,S,128,118,246,0.00002
Phytobacter sp. SCO41,1756993,S,334,247,581,0.00006
Elizabethkingia meningoseptica,238,S,582,31,613,0.00006
Pseudoalteromonas sp. NC201,1514074,S,16,7,23,0
Aerococcus urinaehominis,128944,S,134,2,136,0.00001
Amycolatopsis mediterranei,33910,S,281,-281,0,0
Paenibacillus sp. JDR-2,324057,S,83,5,88,0.00001
Ilyobacter polytropus,167642,S,95,6,101,0.00001
Corynebacterium vitaeruminis,38305,S,330,24,354,0.00003
Burkholderia sp. YI23,1097668,S,129,187,316,0.00003
Gramella sp. MAR_2010_102,1250231,S,53,6,59,0.00001
Winogradskyella sp. J14-2,1936080,S,92,4,96,0.00001
Amycolatopsis albispora,1804986,S,336,153,489,0.00005
Clostridium sp. BNL1100,755731,S,181,2,183,0.00002
Burkholderia sp. OLGA172,1804984,S,399,150,549,0.00005
Muribaculum intestinale,1796646,S,109,1,110,0.00001
Methanothrix soehngenii,2223,S,53202,18,53220,0.00525
Stenotrophomonas sp. Pemsol,2040586,S,722,541,1263,0.00012
Sphingobium sp. MI1205,407020,S,365,363,728,0.00007
Luteimonas sp. 100111,2006110,S,3739,420,4159,0.00041
Erythrobacter litoralis,39960,S,750,195,945,0.00009
Microlunatus phosphovorus,29405,S,3006,163,3169,0.00031
Campylobacter lanienae,75658,S,10,0,10,0
Dechloromonas sp. HYN0024,2231055,S,4154,525,4679,0.00046
Sphingobium sp. SYK-6,627192,S,677,130,807,0.00008
Cryobacterium arcticum,670052,S,247,149,396,0.00004
Octadecabacter temperatus,1458307,S,89,1,90,0.00001
Marinobacter salinus,1874317,S,135,3,138,0.00001
Gardnerella vaginalis,2702,S,1709,38,1747,0.00017
Planctopirus limnophila,120,S,151,3,154,0.00002
Klebsiella quasivariicola,2026240,S,2128,749,2877,0.00028
Actinomyces sp. VUL4_3,1912795,S,40,1,41,0
Micromonospora inositola,47865,S,128,46,174,0.00002
Isoptericola variabilis,139208,S,483,180,663,0.00007
Escherichia phage CICC 80001,1527506,S,10,8,18,0
Nonlabens dokdonensis,328515,S,67,15,82,0.00001
Pseudogulbenkiania sp. NH8B,748280,S,807,145,952,0.00009
Dokdonella koreensis,323415,S,1519,121,1640,0.00016
Mesorhizobium australicum,536018,S,702,320,1022,0.0001
Syntrophobacter fumaroxidans,119484,S,443,109,552,0.00005
Pirellula staleyi,125,S,84,0,84,0.00001
Bdellovibrio exovorus,453816,S,104,2,106,0.00001
Aeromicrobium sp. 592,2079793,S,369,76,445,0.00004
Pseudodesulfovibrio profundus,57320,S,900,421,1321,0.00013
Paenibacillus odorifer,189426,S,50,5,55,0.00001
Polaribacter sp. KT 15,1896175,S,39,98,137,0.00001
Acinetobacter sp. TTH0-4,1646498,S,5412,219,5631,0.00055
Halodesulfurarchaeum formicicum,1873524,S,17,3,20,0
Yersinia phage vB_YenP_AP10,1735591,S,29,0,29,0
Altererythrobacter sp. ZODW24,2185142,S,171,3,174,0.00002
Carnobacterium sp. 17-4,208596,S,248,22,270,0.00003
Bradyrhizobium icense,1274631,S,1097,141,1238,0.00012
Rhodococcus erythropolis,1833,S,979,1455,2434,0.00024
Pseudomonas silesiensis,1853130,S,765,69,834,0.00008
Saccharopolyspora erythraea,1836,S,236,37,273,0.00003
Escherichia phage 121Q,1555202,S,10,5,15,0
Arcobacter sp. L,944547,S,1158,241,1399,0.00014
Flavobacterium sp. AJ004,1981981,S,313,17,330,0.00003
Burkholderia plantarii,41899,S,61,209,270,0.00003
Mycobacteroides abscessus,36809,S,1394,629,2023,0.0002
Anoxybacillus amylolyticus,294699,S,29,5,34,0
Lachnospiraceae bacterium Choco86,2109690,S,13498,1194,14692,0.00145
Nitrosococcus watsonii,473531,S,84,7,91,0.00001
Erysipelotrichaceae bacterium GAM147,2109692,S,17659,9996,27655,0.00273
Capnocytophaga haemolytica,45243,S,73,2,75,0.00001
Microbacterium aurum,36805,S,8264,1973,10237,0.00101
Corynebacterium sp. NML98-0116,702967,S,155,13,168,0.00002
Bradymonas sediminis,1548548,S,87,0,87,0.00001
Sphaerochaeta globosa,1131703,S,59,0,59,0.00001
Escherichia virus FFH1,2049893,S,12,11,23,0
Sphaerochaeta pleomorpha,1131707,S,257,8,265,0.00003
Arcticibacterium luteifluviistationis,1784714,S,79,13,92,0.00001
Rhodococcus sp. WMMA185,679318,S,152,11,163,0.00002
Bifidobacterium indicum,1691,S,21,6,27,0
Woeseia oceani,1548547,S,119,0,119,0.00001
Chloracidobacterium thermophilum,458033,S,73,5,78,0.00001
Maritalea myrionectae,454601,S,124,2,126,0.00001
Streptomyces peucetius,1950,S,115,12,127,0.00001
Methanobrevibacter olleyae,294671,S,58,1,59,0.00001
Cellvibrio sp. PSBB006,1987723,S,111,3,114,0.00001
Serratia sp. YD25,1759437,S,98,22,120,0.00001
Escherichia virus SUSP2,1985291,S,16,7,23,0
Thermobacillus composti,377615,S,178,8,186,0.00002
Candidatus Amoebophilus asiaticus,281120,S,17,0,17,0
Lysinibacillus sp. 2017,2169540,S,62,15,77,0.00001
Zobellella denitrificans,347534,S,380,10,390,0.00004
Colwellia beringensis,1967665,S,17,6,23,0
Clostridium sp. DL-VIII,641107,S,194,1,195,0.00002
Sphingopyxis sp. FD7,1914525,S,3085,542,3627,0.00036
Capnocytophaga sp. ChDC OS43,209053,S,40,15,55,0.00001
Simplicispira suum,2109915,S,17151,1937,19088,0.00188
Bradyrhizobium sp. S23321,335659,S,508,99,607,0.00006
Brevibacterium linens,1703,S,550,193,743,0.00007
Klebsiella quasipneumoniae,1463165,S,2337,2992,5329,0.00053
Campylobacter gracilis,824,S,122,0,122,0.00001
Campylobacter ureolyticus,827,S,53,1,54,0.00001
Sebaldella termitidis,826,S,131397,1448,132845,0.01309
Bacteroides vulgatus,821,S,5957,919,6876,0.00068
Parabacteroides distasonis,823,S,1298,977,2275,0.00022
Nitrosomonas communis,44574,S,136,1,137,0.00001
Nitrosomonas ureae,44577,S,179,71,250,0.00002
Aeromonas virus 65,260149,S,12,0,12,0
Rhodospirillum centenum,34018,S,480,100,580,0.00006
Clostridium autoethanogenum,84023,S,12,2,14,0
Mesorhizobium sp. WSM1497,278153,S,80,501,581,0.00006
secondary endosymbiont of Trabutina mannipara,1835721,S,11,2,13,0
Pectobacterium parmentieri,1905730,S,58,16,74,0.00001
Virgibacillus halodenitrificans,1482,S,36,9,45,0
Methanosarcina sp. Kolksee,1434099,S,22,39,61,0.00001
Spiribacter curvatus,1335757,S,90,2,92,0.00001
Burkholderia sp. JP2-270,2217913,S,109,73,182,0.00002
Herbaspirillum rubrisubalbicans,80842,S,870,205,1075,0.00011
Cnuibacter physcomitrellae,1619308,S,144,1166,1310,0.00013
Pseudomonas orientalis,76758,S,2327,434,2761,0.00027
Pseudomonas monteilii,76759,S,1349,240,1589,0.00016
Cellulomonas flavigena,1711,S,550,138,688,0.00007
Cellulosimicrobium cellulans,1710,S,439,155,594,0.00006
Corynebacterium diphtheriae,1717,S,98,372,470,0.00005
Psychrobacter sp. YP14,2203895,S,3272,4091,7363,0.00073
Corynebacterium pseudotuberculosis,1719,S,34,1,35,0
Corynebacterium glutamicum,1718,S,159,872,1031,0.0001
Mycobacterium virus Bane1,1983109,S,13,8,21,0
Mycobacterium virus BrownCNA,1983108,S,17,7,24,0
Pandoravirus dulcis,1349409,S,11,1,12,0
Acinetobacter virus 133,279006,S,35,0,35,0
Nitratireductor basaltis,472175,S,254,7,261,0.00003
Yersinia massiliensis,419257,S,75,80,155,0.00002
Lachnospiraceae bacterium oral taxon 500,712991,S,439,14,453,0.00004
Salmonella virus SPN3US,1984796,S,151,2,153,0.00002
Ruminococcus champanellensis,1161942,S,1220,76,1296,0.00013
Enterococcus casseliflavus,37734,S,165,167,332,0.00003
Runella sp. HYN0085,2259595,S,130,9,139,0.00001
Thermodesulfobium narugense,184064,S,13,7,20,0
Nocardiopsis gilva,280236,S,203,20,223,0.00002
Roseiflexus sp. RS-1,357808,S,100,10,110,0.00001
Acinetobacter johnsonii,40214,S,174591,121542,296133,0.02919
Acinetobacter junii,40215,S,16872,1639,18511,0.00182
Acinetobacter radioresistens,40216,S,1912,41,1953,0.00019
Micromonospora sp. L5,648999,S,24,225,249,0.00002
Thermincola potens,863643,S,88,4,92,0.00001
Streptococcus ruminantium,1917441,S,8232,159,8391,0.00083
Kyrpidia tusciae,33943,S,33,6,39,0
Geobacillus thermodenitrificans,33940,S,20,87,107,0.00001
Candidatus Paracaedibacter acanthamoebae,91604,S,48,0,48,0
Phaeobacter porticola,1844006,S,273,112,385,0.00004
Massilia sp. YMA4,1593482,S,574,182,756,0.00007
Octadecabacter arcticus,53946,S,243,11,254,0.00003
Kosakonia oryzae,497725,S,260,123,383,0.00004
Hafnia sp. CBA7124,1848580,S,47,67,114,0.00001
Salinicoccus halodurans,407035,S,63,2,65,0.00001
Anaeromyxobacter dehalogenans,161493,S,178,142,320,0.00003
Bordetella parapertussis,519,S,325,1489,1814,0.00018
Bordetella bronchiseptica,518,S,638,1830,2468,0.00024
Capnocytophaga ochracea,1018,S,33,40,73,0.00001
Burkholderia sp. KK1,1855726,S,194,155,349,0.00003
Stenotrophomonas maltophilia,40324,S,17810,14521,32331,0.00319
Pseudomonas savastanoi,29438,S,162,146,308,0.00003
Staphylococcus saprophyticus,29385,S,120,7,127,0.00001
Microvirga sp. 17 mud 1-3,2082949,S,573,73,646,0.00006
Alcaligenes faecalis,511,S,3080,694,3774,0.00037
Actinomyces radicidentis,111015,S,346,102,448,0.00004
Staphylococcus capitis,29388,S,392,38,430,0.00004
Acinetobacter haemolyticus,29430,S,6243,460,6703,0.00066
Sulfitobacter sp. SK025,1389011,S,612,185,797,0.00008
Synechococcus sp. KORDI-49,585423,S,32,6,38,0
Shigella flexneri,623,S,45,78,123,0.00001
Shigella dysenteriae,622,S,111,173,284,0.00003
Rhodoluna lacicola,529884,S,39,6,45,0
Ndongobacter massiliensis,1871025,S,101,5,106,0.00001
Massilia armeniaca,2072590,S,601,191,792,0.00008
Xenorhabdus nematophila,628,S,38,5,43,0
Enterobacter sp. E20,1560339,S,869,787,1656,0.00016
Lachnoclostridium phocaeense,1871021,S,3717,340,4057,0.0004
Nitrosococcus oceani,1229,S,106,8,114,0.00001
Altererythrobacter epoxidivorans,361183,S,363,54,417,0.00004
Cupriavidus sp. USMAA2-4,876364,S,495,2713,3208,0.00032
Carnobacterium inhibens,147709,S,1686,258,1944,0.00019
Pseudarthrobacter equi,728066,S,123,36,159,0.00002
Methanosarcina sp. MTP4,1434100,S,33,6,39,0
Ornithobacterium rhinotracheale,28251,S,404,713,1117,0.00011
Klebsiella phage 0507-KN2-1,1206545,S,20,0,20,0
Nostoc punctiforme,272131,S,22,14,36,0
Tenericutes bacterium MO-XQ,1911684,S,36,7,43,0
Cobetia marina,28258,S,169,49,218,0.00002
Tenericutes bacterium MZ-XQ,1911683,S,17,3,20,0
Acinetobacter lwoffii,28090,S,29126,50070,79196,0.00781
Neisseria weaveri,28091,S,3051,429,3480,0.00034
Lactobacillus jensenii,109790,S,130,1,131,0.00001
Burkholderia gladioli,28095,S,1073,178,1251,0.00012
Lactococcus virus sk1,31532,S,19,39,58,0.00001
[Eubacterium] sulci,143393,S,356,22,378,0.00004
Escherichia virus SU10,1987942,S,56,20,76,0.00001
Rhodococcus fascians,1828,S,1448,560,2008,0.0002
Novibacillus thermophilus,1471761,S,101,5,106,0.00001
Microbulbifer sp. A4B17,359370,S,103,3,106,0.00001
Phoenicibacter massiliensis,1944646,S,537,7,544,0.00005
Staphylococcus succinus,61015,S,65,2,67,0.00001
Clostridium carboxidivorans,217159,S,147,2,149,0.00001
Sphingopyxis sp. LPB0140,1913578,S,73,1,74,0.00001
Spiroplasma helicoides,216938,S,18,3,21,0
Spiroplasma floricola,216937,S,26,5,31,0
Staphylococcus carnosus,1281,S,25,3,28,0
Spiroplasma culicicola,216935,S,19,8,27,0
Streptomyces dengpaensis,2049881,S,144,11,155,0.00002
Spiroplasma chrysopicola,216933,S,12,4,16,0
Gramella salexigens,1913577,S,47,3,50,0
Rhizobium sp. ACO-34A,1571470,S,6838,739,7577,0.00075
Francisella sp. TX077308,573569,S,12,3,15,0
Dictyoglomus thermophilum,14,S,38,0,38,0
Pelobacter carbinolicus,19,S,146,5,151,0.00001
Vibrio sp. 2521-89,2014742,S,14,10,24,0
Pseudomonas arsenicoxydans,702115,S,665,66,731,0.00007
Methylomonas koyamae,702114,S,127,101,228,0.00002
Novosphingobium sp. PP1Y,702113,S,789,460,1249,0.00012
Alistipes shahii,328814,S,1787,326,2113,0.00021
Enterobacter sp. ODB01,1827481,S,592,946,1538,0.00015
Methylovulum psychrotolerans,1704499,S,971,8,979,0.0001
Methanolacinia petrolearia,54120,S,14,5,19,0
Ruminococcus bicirculans,1160721,S,2890,213,3103,0.00031
Erwinia tasmaniensis,338565,S,124,10,134,0.00001
Enterobacteriaceae bacterium ENNIH1,2066051,S,439,142,581,0.00006
Serratia ficaria,61651,S,291,14,305,0.00003
Devosia sp. H5989,1643450,S,903,92,995,0.0001
Rhodovulum sulfidophilum,35806,S,1187,390,1577,0.00016
Pectobacterium wasabiae,55208,S,48,10,58,0.00001
Streptomyces reticuli,1926,S,99,13,112,0.00001
uncultured crAssphage,1211417,S,130102,0,130102,0.01282
Oceanobacillus iheyensis,182710,S,94,6,100,0.00001
Segniliparus rotundus,286802,S,145,2,147,0.00001
Caldicellulosiruptor owensensis,55205,S,22,24,46,0
Flavobacteriaceae bacterium MAR_2010_188,1250295,S,110,2,112,0.00001
Shewanella sp. Pdp11,2059264,S,40,13,53,0.00001
Gordonia phage Emalyn,1821552,S,13,0,13,0
Lactococcus virus c2,31537,S,86,0,86,0.00001
Parageobacillus genomosp. 1,1295642,S,27,5,32,0
Xanthomonas fragariae,48664,S,810,84,894,0.00009
Pseudomonas thivervalensis,86265,S,396,67,463,0.00005
Oceanithermus profundus,187137,S,70,3,73,0.00001
Chlorobium chlorochromatii,337090,S,49,0,49,0
Haloferax mediterranei,2252,S,13,1,14,0
Halomonas huangheensis,1178482,S,127,2,129,0.00001
Arenibacter algicola,616991,S,125,5,130,0.00001
Citromicrobium sp. JL477,1634516,S,446,54,500,0.00005
Xanthomonas vesicatoria,56460,S,1281,546,1827,0.00018
Natrinema pellirubrum,69525,S,18,3,21,0
Acidothermus cellulolyticus,28049,S,88,1,89,0.00001
Agarivorans gilvus,680279,S,86,1,87,0.00001
Escherichia virus Rtp,355246,S,15,1,16,0
Lactococcus phage Tuc2009,35241,S,12,9,21,0
Nitratireductor sp. OM-1,1756988,S,657,53,710,0.00007
Austwickia chelonae,100225,S,328,13,341,0.00003
Sporosarcina psychrophila,1476,S,36,3,39,0
Streptomyces sp. Tu6071,355249,S,17,15,32,0
Rhizobium sp. TAL182,2020313,S,67,212,279,0.00003
Rhizobium sp. CIAT894,2020312,S,786,251,1037,0.0001
Rhizobium sp. Kim5,2020311,S,125,287,412,0.00004
Deinococcus wulumuqiensis,980427,S,90,27,117,0.00001
Comamonadaceae bacterium A1,1458425,S,3973,771,4744,0.00047
Campylobacter curvus,200,S,12,0,12,0
Comamonadaceae bacterium B1,1458426,S,7290,1446,8736,0.00086
Campylobacter sputorum,206,S,66,1,67,0.00001
Magnetospirillum gryphiswaldense,55518,S,598,31,629,0.00006
Endozoicomonas montiporae,1027273,S,78,0,78,0.00001
Paenibacillus yonginensis,1462996,S,90,28,118,0.00001
Ferriphaselus amnicola,1188319,S,491,45,536,0.00005
Serratia fonticola,47917,S,1263,32,1295,0.00013
Polynucleobacter asymbioticus,576611,S,94,334,428,0.00004
Polynucleobacter necessarius,576610,S,540,47,587,0.00006
Paenalcaligenes hominis,643674,S,368,9,377,0.00004
Enterobacter sp. CRENT-193,2051905,S,22,424,446,0.00004
Nocardioides dokdonensis,450734,S,1029,274,1303,0.00013
Paenibacillus naphthalenovorans,162209,S,93,4,97,0.00001
Bacillus smithii,1479,S,32,12,44,0
Streptomyces sp. 2323.1,1938841,S,93,10,103,0.00001
Staphylococcus virus IPLAC1C,1980931,S,11,8,19,0
Psychromonas ingrahamii,357794,S,49,3,52,0.00001
Vibrio sp. dhg,2163016,S,57,160,217,0.00002
Salimicrobium jeotgali,1230341,S,26,0,26,0
Methanothermus fervidus,2180,S,53,2,55,0.00001
Bacillus beveridgei,632773,S,40,4,44,0
alpha proteobacterium HIMB5,859653,S,28,4,32,0
Bordetella sp. HZ20,2163011,S,449,27,476,0.00005
Desulfococcus oleovorans,181663,S,141,1,142,0.00001
Dehalogenimonas formicexedens,1839801,S,55,0,55,0.00001
Halothiobacillus sp. LS2,1860122,S,256,4,260,0.00003
Stenotrophomonas virus IME13,1921529,S,24,14,38,0
Capnocytophaga sp. H2931,1945657,S,11,40,51,0.00001
Streptococcus salivarius,1304,S,13843,3848,17691,0.00174
Gordonia phage GTE7,1100814,S,26,48,74,0.00001
Prevotella ruminicola,839,S,246,0,246,0.00002
Pseudomonas virus PaMx74,1982358,S,245,0,245,0.00002
Rhodococcus sp. YL-1,1045808,S,554,1129,1683,0.00017
Dialister pneumosintes,39950,S,968,22,990,0.0001
Gloeobacter kilaueensis,1416614,S,65,1,66,0.00001
Draconibacterium orientale,1168034,S,403,15,418,0.00004
Streptococcus suis,1307,S,519344,34984,554328,0.05463
Streptomyces collinus,42684,S,100,12,112,0.00001
Paraburkholderia phymatum,148447,S,365,92,457,0.00005
Cellulomonas sp. PSBB021,2003551,S,801,424,1225,0.00012
Sulfurospirillum deleyianum,65553,S,81,2,83,0.00001
Lactococcus virus bIL67,36343,S,208,20,228,0.00002
Mycoplasma hominis,2098,S,19,11,30,0
Desulfocapsa sulfexigens,65555,S,178,29,207,0.00002
Thermoplasmatales archaeon BRNA1,1054217,S,10,1,11,0
Rahnella sp. Y9602,741091,S,34,228,262,0.00003
Porphyrobacter HT-58-2,2023229,S,821,168,989,0.0001
Hydrogenophaga sp. PBC,795665,S,9489,2977,12466,0.00123
Streptococcus oralis,1303,S,2603,500,3103,0.00031
Hyphomonas sp. Mor2,1906738,S,150,2,152,0.00001
Halioglobus japonicus,930805,S,105,1,106,0.00001
Rhodococcus sp. MTM3W5.2,1805827,S,418,59,477,0.00005
Geobacter anodireducens,1340425,S,94,53,147,0.00001
Planococcus faecalis,1598147,S,11,21,32,0
Verrucomicrobia bacterium IMCC26134,1637999,S,167,7,174,0.00002
Dickeya dianthicola,204039,S,235,113,348,0.00003
Dickeya dadantii,204038,S,191,10,201,0.00002
Lacinutrix venerupis,1486034,S,105,20,125,0.00001
Azoarcus sp. BH72,62928,S,306,887,1193,0.00012
Verrucomicrobium sp. GAS474,1882831,S,125,0,125,0.00001
Methylibium petroleiphilum,105560,S,3131,769,3900,0.00038
Frankineae bacterium MT45,1882833,S,171,29,200,0.00002
Paenibacillaceae bacterium GAS479,1882832,S,109,17,126,0.00001
Streptococcus mutans,1309,S,1364,75,1439,0.00014
Bradyrhizobium erythrophlei,1437360,S,2114,158,2272,0.00022
Shewanella sp. ANA-3,94122,S,123,36,159,0.00002
Luteimonas sp. JM171,1896164,S,3506,320,3826,0.00038
Heliobacterium modesticaldum,35701,S,318,55,373,0.00004
Enterobacteria phage vB_KleM-RaK2,1147094,S,27,23,50,0
Carnobacterium divergens,2748,S,1678,107,1785,0.00018
Pedobacter cryoconitis,188932,S,94,11,105,0.00001
Rhodococcus rhodochrous,1829,S,265,75,340,0.00003
Brevundimonas subvibrioides,74313,S,2556,228,2784,0.00027
Actinosynnema pretiosum,42197,S,174,392,566,0.00006
Methanosarcina acetivorans,2214,S,12,0,12,0
Herbaspirillum sp. meg3,2025949,S,488,38,526,0.00005
Clostridium aceticum,84022,S,85,1,86,0.00001
Maricaulis maris,74318,S,212,8,220,0.00002
Modestobacter marinus,477641,S,366,64,430,0.00004
Hyphomonas neptunium,81032,S,199,29,228,0.00002
Spiroplasma taiwanense,2145,S,17,2,19,0
Candidatus Methanomethylophilus alvus,1291540,S,12,2,14,0
Brucella sp. 141012304,1885919,S,85,59,144,0.00001
Acidithiobacillus ferrooxidans,920,S,162,5,167,0.00002
Starkeya novella,921,S,1565,252,1817,0.00018
Candidatus Ruthia magnifica,386487,S,15,2,17,0
Pseudomonas cichorii,36746,S,826,28,854,0.00008
Thiomonas intermedia,926,S,4729,1126,5855,0.00058
Halothiobacillus neapolitanus,927,S,278,8,286,0.00003
Psychrobacter sp. PRwf-1,349106,S,3885,4792,8677,0.00086
Haloterrigena turkmenica,62320,S,39,1,40,0
Shewanella baltica,62322,S,658,172,830,0.00008
Labrenzia sp. CP4,1674922,S,90,163,253,0.00002
Streptomyces sp. CMB-StM0423,2059884,S,83,10,93,0.00001
Geobacter pickeringii,345632,S,164,7,171,0.00002
Acetobacter persici,1076596,S,124,5,129,0.00001
Labrenzia sp. VG12,2021862,S,398,15,413,0.00004
Pediococcus claussenii,187452,S,195,555,750,0.00007
Virgibacillus sp. SK37,403957,S,31,7,38,0
Aeromonas virus AS4,1921528,S,26,14,40,0
Corynebacterium atypicum,191610,S,152,18,170,0.00002
Neisseria elongata,495,S,3618,1179,4797,0.00047
Methyloceanibacter sp. wino2,2170729,S,200,53,253,0.00002
Paraburkholderia phenoliruptrix,252970,S,114,762,876,0.00009
Fibrobacter succinogenes,833,S,59,0,59,0.00001
Butyrivibrio fibrisolvens,831,S,935,114,1049,0.0001
Porphyromonas gingivalis,837,S,135,18,153,0.00002
Candidatus Pantoea carbekii,1235990,S,20,0,20,0
Neisseria sicca,490,S,432,1145,1577,0.00016
Pseudomonas chlororaphis,587753,S,3057,840,3897,0.00038
Bosea sp. AS-1,2015316,S,13948,2383,16331,0.00161
Halioglobus pacificus,930806,S,159,2,161,0.00002
Dehalobacter sp. CF,1131462,S,662,1288,1950,0.00019
Thauera sp. MZ1T,85643,S,7432,2427,9859,0.00097
Francisella hispaniensis,622488,S,17,25,42,0
Psychrobacter urativorans,45610,S,10854,207,11061,0.00109
[Mycobacterium] stephanolepidis,1520670,S,221,61,282,0.00003
Methylocella silvestris,199596,S,395,20,415,0.00004
Desulfovibrio fairfieldensis,44742,S,3525,55,3580,0.00035
Dokdonia sp. Dokd-P16,2173169,S,59,19,78,0.00001
Microbacterium paraoxydans,199592,S,355,3775,4130,0.00041
Chitinophaga caeni,2029983,S,72,7,79,0.00001
Caulobacter phage CcrColossus,1211640,S,14,0,14,0
Escherichia virus JenP2,1921121,S,16,5,21,0
Azospirillum sp. TSH58,664962,S,202,280,482,0.00005
Ectothiorhodospira sp. BSL-9,1442136,S,258,13,271,0.00003
Pleurocapsa minor,54308,S,35,3,38,0
Aurantimicrobium sp. MWH-Mo1,1987356,S,103,7,110,0.00001
Caulobacter virus Rogue,1211643,S,13,4,17,0
Vibrio tritonius,1435069,S,72,1,73,0.00001
Spiribacter salinus,1335746,S,88,3,91,0.00001
Cryobacterium sp. LW097,1978566,S,330,59,389,0.00004
Aliivibrio wodanis,80852,S,39,3,42,0
Nocardiopsis alba,53437,S,173,31,204,0.00002
Phycisphaerae bacterium L21-RPul-D3,1940790,S,21,7,28,0
Moritella viscosa,80854,S,55,6,61,0.00001
Natronobacterium gregoryi,44930,S,13,0,13,0
Rickettsia akari,786,S,11,56,67,0.00001
Streptococcus sp. FDAARGOS_192,1839799,S,954,759,1713,0.00017
Salinibacterium sp. CGMCC 1.16371,2079791,S,337,25,362,0.00004
Escherichia virus JenP1,1921120,S,15,4,19,0
Exiguobacterium sp. AT1b,360911,S,187,6,193,0.00002
Mycetocola sp. CGMCC 1.16372,2079792,S,368,27,395,0.00004
Asticcacaulis excentricus,78587,S,312,8,320,0.00003
Corynebacterium variabile,1727,S,954,416,1370,0.00014
Corynebacterium renale,1724,S,43,59,102,0.00001
Mycobacterium virus Stinger,1983119,S,11,6,17,0
Brevibacterium siliguriense,1136497,S,154,18,172,0.00002
Haloterrigena daqingensis,588898,S,14,0,14,0
Lactobacillus apis,303541,S,39,0,39,0
Corynebacterium callunae,1721,S,56,9,65,0.00001
Rhodothermaceae bacterium RA,1779382,S,51,52,103,0.00001
Oligotropha carboxidovorans,40137,S,1438,632,2070,0.0002
Devriesea agamarum,472569,S,87,3,90,0.00001
Achromobacter phage phiAxp-3,1664247,S,41,0,41,0
Parachlamydia acanthamoebae,83552,S,68,6,74,0.00001
Cyanobacterium aponinum,379064,S,54,4,58,0.00001
Aliivibrio salmonicida,40269,S,24,2,26,0
Simiduia agarivorans,447471,S,174,1,175,0.00002
Streptomyces bingchenggensis,379067,S,212,15,227,0.00002
Corynebacterium imitans,156978,S,118,14,132,0.00001
Corynebacterium riegelii,156976,S,151,12,163,0.00002
Burkholderia sp. RPE67,758796,S,91,131,222,0.00002
Bacillus glycinifermentans,1664069,S,54,2,56,0.00001
Pseudomonas sp. M30-35,1981174,S,544,7,551,0.00005
Carnobacterium sp. CP1,1564681,S,268,17,285,0.00003
Paenibacillus sp. CAA11,1532905,S,89,7,96,0.00001
Vitreoscilla filiformis,63,S,3238,195,3433,0.00034
Nocardioides sp. 78,2045452,S,691,164,855,0.00008
Microbacterium sp. TPU 3598,1938334,S,2221,341,2562,0.00025
Lysobacter enzymogenes,69,S,6474,3138,9612,0.00095
Lactobacillus pentosus,1589,S,154,5,159,0.00002
Methanolobus psychrophilus,420950,S,14,0,14,0
Spirochaeta africana,46355,S,43,0,43,0
Burkholderiales bacterium GJ-E10,1469502,S,721,18,739,0.00007
Flavobacterium anhuiense,459526,S,166,636,802,0.00008
Lactobacillus brevis,1580,S,606,67,673,0.00007
Lactobacillus buchneri,1581,S,139,5,144,0.00001
Verrucomicrobia bacterium,2026799,S,242,5,247,0.00002
Yangia sp. CCB-MM3,1792508,S,914,153,1067,0.00011
Lactobacillus delbrueckii,1584,S,2558,148,2706,0.00027
Acidipropionibacterium virtanenii,2057246,S,355,56,411,0.00004
Campylobacter pinnipediorum,1965231,S,58,0,58,0.00001
Methylorubrum zatmanii,29429,S,14,86,100,0.00001
Sulfitobacter sp. SK011,1389004,S,228,10,238,0.00002
Sulfitobacter sp. SK012,1389005,S,152,5,157,0.00002
Kingella kingae,504,S,899,160,1059,0.0001
Singulisphaera acidiphila,466153,S,118,6,124,0.00001
Legionella oakridgensis,29423,S,33,5,38,0
Thermomicrobium roseum,500,S,31,0,31,0
Yersinia enterocolitica,630,S,767,51,818,0.00008
Vibrio rumoiensis,76258,S,540,53,593,0.00006
Yersinia pestis,632,S,258,505,763,0.00008
Yersinia pseudotuberculosis,633,S,80,29,109,0.00001
Arthrospira platensis,118562,S,22,54,76,0.00001
Edwardsiella tarda,636,S,167,123,290,0.00003
Pseudomonas sp. TMW 2.1634,1886807,S,3309,10998,14307,0.00141
Marinobacter sp. Arc7-DN-1,2304594,S,94,5,99,0.00001
Prochlorococcus marinus,1219,S,84,20,104,0.00001
Hymenobacter sp. PAMC 26554,1484116,S,91,5,96,0.00001
Burkholderia sp. PAMC 26561,1795043,S,115,85,200,0.00002
Clostridium taeniosporum,394958,S,134,0,134,0.00001
Renibacterium salmoninarum,1646,S,105,3,108,0.00001
Arthrobacter sp. YN,2020486,S,120,12,132,0.00001
Pseudomonas phage VCM,1729937,S,28,0,28,0
Monoglobus pectinilyticus,1981510,S,2319,99,2418,0.00024
Crenobacter sp. K1W11S-77,2290923,S,589,95,684,0.00007
Lysobacter sp. TY2-98,2290922,S,2747,251,2998,0.0003
Zhongshania aliphaticivorans,1470434,S,197,2,199,0.00002
Sporosarcina ureae,1571,S,133,33,166,0.00002
Vagococcus teuberi,519472,S,568,62,630,0.00006
Sphingomonas taxi,1549858,S,1020,49,1069,0.00011
Erythrobacter sp. YH-07,2182384,S,322,20,342,0.00003
Haematospirillum jordaniae,1549855,S,172,9,181,0.00002
Aeromonas phage pAh6-C,1505227,S,426,0,426,0.00004
Oscillibacter valericigenes,351091,S,2130,21,2151,0.00021
Thermodesulfovibrio yellowstonii,28262,S,58,0,58,0.00001
Pseudomonas virus NP1,1982240,S,180,0,180,0.00002
Prosthecochloris aestuarii,1102,S,41,0,41,0
Rubrivivax gelatinosus,28068,S,3609,832,4441,0.00044
Bacillus atrophaeus,1452,S,15,8,23,0
Geobacter bemidjiensis,225194,S,80,11,91,0.00001
Gordonibacter massiliensis,1841863,S,529,8,537,0.00005
Mycobacterium virus Nigel,1983118,S,25,6,31,0
Chloroflexus aurantiacus,1108,S,59,-59,0,0
Psychrobacter cryohalolentis,330922,S,26928,15773,42701,0.00421
Mogibacterium diversum,114527,S,329,74,403,0.00004
Shewanella loihica,359303,S,115,4,119,0.00001
Streptomyces pluripotens,1355015,S,120,9,129,0.00001
Devosia sp. A16,1736675,S,1342,110,1452,0.00014
Algibacter alginicilyticus,1736674,S,129,15,144,0.00001
Lactococcus phage phi7,1262538,S,119,30,149,0.00001
Leptotrichia sp. oral taxon 498,712368,S,391,368,759,0.00007
Pseudomonas cerasi,1583341,S,84,151,235,0.00002
Lactococcus phage BM13,1229751,S,15,3,18,0
Thermocrinis minervae,381751,S,34,6,40,0
Francisella sp. TX077310,573570,S,10,0,10,0
Spiroplasma turonicum,216946,S,14,3,17,0
Anabaena sp. WA102,1647413,S,28,26,54,0.00001
Spiroplasma syrphidicola,216945,S,10,3,13,0
Marinilactibacillus sp. 15R,1911586,S,394,42,436,0.00004
Virgibacillus sp. 6R,1911587,S,197,6,203,0.00002
Candidatus Thioglobus autotrophicus,1705394,S,48,7,55,0.00001
Glaciecola sp. 4H-3-7+YE-5,983545,S,45,8,53,0.00001
Sphingobium hydrophobicum,1673076,S,1741,812,2553,0.00025
Sporosarcina sp. PTS2304,2283194,S,34,8,42,0
Ornithinimicrobium sp. AMA3305,2283195,S,672,108,780,0.00008
Kluyvera intermedia,61648,S,1027,314,1341,0.00013
Lactobacillus hokkaidonensis,1193095,S,210,21,231,0.00002
Lelliottia amnigena,61646,S,2378,114,2492,0.00025
Pluralibacter gergoviae,61647,S,1087,40,1127,0.00011
Comamonas aquatica,225991,S,21528,4621,26149,0.00258
Enterobacter asburiae,61645,S,8146,4426,12572,0.00124
Bordetella holmesii,35814,S,591,67,658,0.00006
Salmonella phage BPS11Q3,1857099,S,19,17,36,0
Bdellovibrio bacteriovorus,959,S,810,16,826,0.00008
Escherichia virus IME11,1920759,S,126,7,133,0.00001
Escherichia virus ECBP1,1920758,S,46,41,87,0.00001
Spiroplasma apis,2137,S,14,1,15,0
Rhodococcus pyridinivorans,103816,S,162,649,811,0.00008
Petrimonas mucosa,1642646,S,290,32,322,0.00003
Erwinia persicina,55211,S,330,25,355,0.00003
Escherichia virus Bp4,1920757,S,56,39,95,0.00001
Escherichia virus APEC5,1920756,S,178,92,270,0.00003
Escherichia virus APEC7,1920755,S,179,91,270,0.00003
Rhodococcus sp. BH4,1807790,S,429,1064,1493,0.00015
Klebsiella virus PKO111,1985327,S,37,11,48,0
Klebsiella virus JD18,1985326,S,73,17,90,0.00001
Arachidicoccus sp. BS20,1850526,S,97,24,121,0.00001
Mycolicibacterium rutilum,370526,S,1312,342,1654,0.00016
Friedmanniella sagamiharensis,546874,S,510,75,585,0.00006
Flagellimonas sp. HME9304,1383885,S,81,1,82,0.00001
Micromonospora auratinigra,261654,S,127,50,177,0.00002
Spiroplasma citri,2133,S,17,38,55,0.00001
Moritella yayanosii,69539,S,55,12,67,0.00001
Selenomonas sputigena,69823,S,333,4,337,0.00003
Neorickettsia sennetsu,951,S,13,1,14,0
Nocardioides sp. JS614,196162,S,2731,525,3256,0.00032
Francisella philomiragia,28110,S,22,22,44,0
Bacteroides heparinolyticus,28113,S,187,33,220,0.00002
Lonsdalea britannica,1082704,S,172,4,176,0.00002
Escherichia phage LM33_P1,1788294,S,46,24,70,0.00001
Gordonia sp. YC-JH1,2059875,S,1130,908,2038,0.0002
Streptococcus sp. A12,1759399,S,1140,121,1261,0.00012
Mycolicibacterium vanbaalenii,110539,S,1807,792,2599,0.00026
Flavobacteriaceae bacterium UJ101,1150389,S,130,4,134,0.00001
Paenibacillus swuensis,1178515,S,41,2,43,0
Halomonas sp. GT,1971364,S,95,24,119,0.00001
Pseudomonas phage phiPsa374,1458843,S,35,3,38,0
Helicobacter felis,214,S,17,0,17,0
Halostagnicola larsenii,353800,S,12,0,12,0
Kiritimatiella glycovorans,1307763,S,237,53,290,0.00003
Helicobacter cinaedi,213,S,24,2,26,0
Helicobacter pylori,210,S,85,35,120,0.00001
Kitasatospora sp. MMS16-BH015,2018025,S,247,57,304,0.00003
Brochothrix phage A9,857312,S,31,0,31,0
Janthinobacterium agaricidamnosum,55508,S,948,36,984,0.0001
Nostoc linckia,92942,S,33,11,44,0
Ketogulonicigenium robustum,92947,S,791,78,869,0.00009
Ketogulonicigenium vulgare,92945,S,796,134,930,0.00009
Paenibacillus kribbensis,172713,S,31,4,35,0
Brucella vulpis,981386,S,68,32,100,0.00001
Cellulosimicrobium sp. TH-20,1980001,S,563,256,819,0.00008
Calothrix sp. NIES-2098,1954171,S,22,7,29,0
Calothrix sp. NIES-2100,1954172,S,17,6,23,0
Lelliottia nimipressuralis,69220,S,449,80,529,0.00005
Dickeya paradisiaca,69223,S,209,2,211,0.00002
Plantactinospora sp. KBS50,2024580,S,199,38,237,0.00002
Halorientalis sp. IM1011,1932360,S,26,2,28,0
Candidatus Profftella armatura,669502,S,105,3,108,0.00001
Sphaerospermopsis kisseleviana,289435,S,18,3,21,0
Alcanivorax pacificus,1306787,S,415,16,431,0.00004
Rhizobium sp. NXC14,1981173,S,515,138,653,0.00006
Enterobacteriaceae bacterium S05,2052938,S,92,288,380,0.00004
Dinoroseobacter shibae,215813,S,1003,828,1831,0.00018
Arthrobacter sp. ERGS1:01,1704044,S,243,17,260,0.00003
Anabaenopsis circularis,109266,S,17,8,25,0
Chromobacterium rhizoryzae,1778675,S,776,91,867,0.00009
Thermococcus guaymasensis,110164,S,11,4,15,0
Simkania negevensis,83561,S,12,0,12,0
Bacteroides salanitronis,376805,S,514,43,557,0.00005
Dyella jiangningensis,1379159,S,783,144,927,0.00009
Bacteroides dorei,357276,S,7989,1191,9180,0.0009
Neoasaia chiangmaiensis,320497,S,176,13,189,0.00002
Citrobacter sp. CRE-46,1703250,S,246,416,662,0.00007
Streptococcus pantholopis,1811193,S,931,9,940,0.00009
Pseudomonas virus Kakheti25,1921546,S,17,30,47,0
Chryseobacterium piperi,558152,S,533,160,693,0.00007
Azospirillum sp. M2T2B2,682998,S,320,195,515,0.00005
Melissococcus plutonius,33970,S,98,1,99,0.00001
Sphingobium chlorophenolicum,46429,S,421,130,551,0.00005
Synechococcus sp. WH 8109,166314,S,45,27,72,0.00001
Marinobacter sp. LV10R510-11A,1415568,S,157,1,158,0.00002
Geobacter sp. DSM 9736,1277350,S,93,1,94,0.00001
Rhizobium sp. IRBG74,424182,S,756,2103,2859,0.00028
Enterobacter sp. FY-07,1692238,S,651,15,666,0.00007
Neorhizobium sp. SOG26,2060726,S,1147,179,1326,0.00013
Dietzia timorensis,499555,S,281,204,485,0.00005
Chryseobacterium sp. IHB B 17019,1721091,S,759,232,991,0.0001
Bosea sp. RAC05,1842539,S,7363,2292,9655,0.00095
Ramlibacter tataouinensis,94132,S,13094,1146,14240,0.0014
Streptococcus infantarius,102684,S,6528,1810,8338,0.00082
Candidatus Izimaplasma sp. HR1,1541959,S,59,0,59,0.00001
Porphyrobacter sp. LM 6,1896196,S,1004,218,1222,0.00012
Pelobacter sp. SFB93,1842532,S,98,11,109,0.00001
Acidovorax sp. RAC01,1842533,S,76472,21546,98018,0.00966
Sinorhizobium sp. RAC02,1842534,S,14183,2129,16312,0.00161
Blastomonas sp. RAC04,1842535,S,451,355,806,0.00008
Agrobacterium sp. RAC06,1842536,S,2504,226,2730,0.00027
Hydrogenophaga sp. RAC07,1842537,S,9738,946,10684,0.00105
Scytonema sp. NIES-4073,2005464,S,10,10,20,0
Methylobacterium oryzae,334852,S,33,468,501,0.00005
bacterium 2013Arg42i,1561003,S,13,0,13,0
Aurantimicrobium sp. MWH-Uga1,2079575,S,36,11,47,0
Calothrix sp. NIES-4101,2005461,S,40,7,47,0
Pseudodesulfovibrio aespoeensis,182210,S,682,200,882,0.00009
Prevotella melaninogenica,28132,S,245,141,386,0.00004
[Clostridium] saccharolyticum,84030,S,4770,310,5080,0.0005
Pseudoclostridium thermosuccinogenes,84032,S,104,7,111,0.00001
Calothrix sp. 336/3,1337936,S,27,5,32,0
Methanobrevibacter smithii,2173,S,72168,790,72958,0.00719
Vibrio cholerae,666,S,221,83,304,0.00003
Desulfosporosinus acidiphilus,885581,S,65,3,68,0.00001
Sphingomonas sp. Cra20,1327635,S,586,11,597,0.00006
Winogradskyella sp. PG-2,754409,S,95,5,100,0.00001
Nitrosomonas europaea,915,S,1155,83,1238,0.00012
Nitrosomonas eutropha,916,S,363,50,413,0.00004
Serratia sp. FS14,1327989,S,13,27,40,0
Nitrobacter winogradskyi,913,S,629,83,712,0.00007
Nitrobacter hamburgensis,912,S,848,125,973,0.0001
Tessaracoccus flavus,1610493,S,2772,320,3092,0.0003
Bathymodiolus septemdierum thioautotrophic gill symbiont,113267,S,49,8,57,0.00001
Pseudonocardia sp. HH130630-07,1690815,S,245,202,447,0.00004
Hymenobacter sp. PAMC 26628,1484118,S,118,36,154,0.00002
Yersinia phage phiR201,1206557,S,61,1,62,0.00001
Pajaroellobacter abortibovis,1882918,S,12,0,12,0
Brevibacterium sandarakinum,629680,S,245,37,282,0.00003
Gilliamella apicola,1196095,S,52,1,53,0.00001
Bacillus subtilis,1423,S,252,737,989,0.0001
Kangiella geojedonensis,914150,S,35,1,36,0
Streptococcus cristatus,45634,S,1654,107,1761,0.00017
Pseudomonas sp. DR 5-09,1534110,S,386,110,496,0.00005
Pseudomonas sp. 31-12,2201356,S,504,73,577,0.00006
Novosphingobium sp. P6W,1609758,S,745,29,774,0.00008
Phenylobacterium sp. HYN0004,2201350,S,999,81,1080,0.00011
Miniimonas sp. S16,2171623,S,4443,1231,5674,0.00056
Microbacterium chocolatum,84292,S,1727,303,2030,0.0002
Halotalea alkalilenta,376489,S,331,18,349,0.00003
Rivularia sp. PCC 7116,373994,S,30,1,31,0
Oxalobacter formigenes,847,S,297,9,306,0.00003
Thioalkalivibrio sulfidiphilus,1033854,S,605,97,702,0.00007
Ochrobactrum pseudogrignonense,419475,S,407,280,687,0.00007
Bordetella petrii,94624,S,2106,1161,3267,0.00032
Sandaracinus amylolyticus,927083,S,236,11,247,0.00002
Streptomyces albulus,68570,S,157,23,180,0.00002
Oleispira antarctica,188908,S,156,2,158,0.00002
Fusobacterium gonidiaformans,849,S,164,20,184,0.00002
Burkholderia sp. MSMB0266,1637837,S,18,20,38,0
Tatumella citrea,53336,S,88,2,90,0.00001
Mycobacterium sp. YC-RL4,1682113,S,5508,1279,6787,0.00067
Burkholderia sp. MSMB617WGS,1637831,S,10,16,26,0
Bacillus thuringiensis,1428,S,331,1520,1851,0.00018
Desulfovibrio magneticus,184917,S,6152,40,6192,0.00061
Phycisphaerae bacterium ST-PulAB-D4,1941349,S,12,1,13,0
Corallococcus coralloides,184914,S,227,74,301,0.00003
Pseudomonas plecoglossicida,70775,S,688,562,1250,0.00012
Acidovorax avenae,80867,S,14121,5486,19607,0.00193
Delftia acidovorans,80866,S,3095,7752,10847,0.00107
Actinobacteria bacterium IMCC26077,1848755,S,21,0,21,0
Acidovorax sp. T1,1858609,S,78676,86648,165324,0.01629
Enterococcus cecorum,44008,S,1028,106,1134,0.00011
Pseudomonas virus Ab18,1982096,S,11,0,11,0
Caldicellulosiruptor saccharolyticus,44001,S,48,13,61,0.00001
Acidovorax citrulli,80869,S,4827,2973,7800,0.00077
Acidovorax cattleyae,80868,S,4556,2090,6646,0.00066
Massilia violaceinigra,2045208,S,789,45,834,0.00008
Acinetobacter phage Acj61,760732,S,414,0,414,0.00004
Synechococcus phage S-ShM2,445683,S,29,0,29,0
Streptomyces xinghaiensis,1038928,S,172,20,192,0.00002
Pseudomonas sp. s211(2017),2045200,S,139,227,366,0.00004
Yersinia similis,367190,S,75,2,77,0.00001
Nodularia spumigena,70799,S,12,2,14,0
Lactococcus phage P335 sensu lato,354260,S,27,13,40,0
Peptoclostridium acidaminophilum,1731,S,9405,65,9470,0.00093
Fusobacterium sp. oral taxon 203,671211,S,60,106,166,0.00002
Lysobacter capsici,435897,S,3572,1666,5238,0.00052
Fibrella aestuarina,651143,S,82,5,87,0.00001
Calothrix sp. PCC 7507,99598,S,26,3,29,0
Eubacterium limosum,1736,S,1813,25,1838,0.00018
Paraburkholderia caffeinilytica,1761016,S,305,85,390,0.00004
Pectobacterium phage Peat1,1654601,S,35,16,51,0.00001
Neisseria sp. KEM232,655307,S,4291,276,4567,0.00045
Pseudomonas trivialis,200450,S,2231,533,2764,0.00027
Thiolapillus brandeum,1076588,S,108,0,108,0.00001
Gammaproteobacteria bacterium ESL0073,2070539,S,62,0,62,0.00001
Lysinibacillus sp. Marseille-P5727,2086577,S,103,17,120,0.00001
Gallibacterium anatis,750,S,160,7,167,0.00002
Pseudomonas parafulva,157782,S,927,63,990,0.0001
Pseudomonas cremoricolorata,157783,S,550,22,572,0.00006
Pasteurella dagmatis,754,S,60,3,63,0.00001
Chania multitudinisentens,1639108,S,191,213,404,0.00004
Lactobacillus paracasei,1597,S,723,1075,1798,0.00018
Lactobacillus gasseri,1596,S,4131,136,4267,0.00042
Myxococcus hansupus,1297742,S,124,35,159,0.00002
Sulfurospirillum halorespirans,194424,S,63,32,95,0.00001
Kurthia sp. 11kri321,1750719,S,330,40,370,0.00004
Leuconostoc citreum,33964,S,1432,202,1634,0.00016
Actinoplanes sp. N902-109,649831,S,297,111,408,0.00004
Bordetella trematum,123899,S,959,139,1098,0.00011
Lactobacillus reuteri,1598,S,4553,161,4714,0.00046
Actinotignum schaalii,59505,S,141,24,165,0.00002
Sutterella sp. 6FBBBH3,2259134,S,399,11,410,0.00004
Micromonospora purpureochromogenes,47872,S,162,65,227,0.00002
Staphylococcus pasteuri,45972,S,89,7,96,0.00001
Hoeflea sp. IMCC20628,1620421,S,511,35,546,0.00005
Pseudomonas amygdali,47877,S,76,267,343,0.00003
Rhodobiaceae bacterium,2026785,S,84,2,86,0.00001
Pseudomonas corrugata,47879,S,512,75,587,0.00006
Pseudomonas azotoformans,47878,S,3352,1068,4420,0.00044
Candidatus Midichloria mitochondrii,234827,S,16,0,16,0
Amycolatopsis sp. AA4,1896961,S,302,39,341,0.00003
Candidatus Methylopumilus turicensis,1581680,S,86,10,96,0.00001
Verrucomicrobium spinosum,2736,S,365,0,365,0.00004
Gemella morbillorum,29391,S,161,3,164,0.00002
Streptomyces globosus,68209,S,140,21,161,0.00002
Methanocorpusculum labreanum,83984,S,12,0,12,0
Xylanimonas cellulosilytica,186189,S,433,85,518,0.00005
Cupriavidus nantongensis,1796606,S,1480,1869,3349,0.00033
Polaribacter sp. BM10,1529069,S,77,192,269,0.00003
Sphingomonas sp. NIC1,1961362,S,740,402,1142,0.00011
Methylovorus sp. MP688,887061,S,120,109,229,0.00002
Microbulbifer aggregans,1769779,S,207,5,212,0.00002
Rhizobium phaseoli,396,S,888,2004,2892,0.00029
Paraburkholderia terricola,169427,S,287,72,359,0.00004
Shewanella bicestrii,2018305,S,45,24,69,0.00001
Yersinia intermedia,631,S,480,1532,2012,0.0002
Lactobacillus acidipiscis,89059,S,152,7,159,0.00002
Microbacterium sp. PAMC 28756,1795053,S,688,1411,2099,0.00021
Psychrobacter sp. AntiMn-1,1720344,S,9332,283,9615,0.00095
Trichodesmium erythraeum,1206,S,13,0,13,0
Raoultella sp. X13,2259647,S,92,648,740,0.00007
Moraxella osloensis,34062,S,465360,7530,472890,0.04661
Agrococcus carbonis,684552,S,763,216,979,0.0001
Acinetobacter phage vB_AbaM_Acibel004,1481186,S,94,0,94,0.00001
Mycobacterium ulcerans,1809,S,23,15,38,0
Sphingomonas sp. FARSPH,2219696,S,1287,228,1515,0.00015
Planococcus sp. PAMC 21323,1526927,S,20,3,23,0
Acinetobacter lactucae,1785128,S,237,14,251,0.00002
Paenibacillus sp. FSL R5-0345,1536770,S,28,8,36,0
Siansivirga zeaxanthinifaciens,762954,S,179,21,200,0.00002
Candidatus Accumulibacter phosphatis,327160,S,2066,36,2102,0.00021
Erythrobacter atlanticus,1648404,S,280,110,390,0.00004
Sphingorhabdus flavimaris,266812,S,231,33,264,0.00003
Nocardia terpenica,455432,S,363,51,414,0.00004
Novosphingobium pentaromativorans,205844,S,716,824,1540,0.00015
Lactobacillus kefiranofaciens,267818,S,120,10,130,0.00001
Lachnoclostridium phytofermentans,66219,S,521,4,525,0.00005
Luteipulveratus mongoliensis,571913,S,441,28,469,0.00005
Porphyrobacter neustonensis,1112,S,946,130,1076,0.00011
Corynebacterium mustelae,571915,S,30,0,30,0
Enterococcus faecium,1352,S,5384,3294,8678,0.00086
Nitrospirillum amazonense,28077,S,713,65,778,0.00008
Paenibacillus sp. FSL H7-0737,1536775,S,43,13,56,0.00001
Nostoc sp. PCC 7524,28072,S,10,1,11,0
Amphibacillus xylanus,1449,S,81,2,83,0.00001
Streptomyces sp. SirexAA-E,862751,S,97,13,110,0.00001
Lactococcus virus P008,83129,S,47,25,72,0.00001
Nitrospira moscoviensis,42253,S,81,0,81,0.00001
Arthrobacter sp. QXT-31,1357915,S,205,17,222,0.00002
Sphingopyxis sp. QXT-31,1357916,S,3626,254,3880,0.00038
Lactobacillus zymae,267363,S,46,4,50,0
Pseudomonas sp. JY-Q,1338689,S,123,285,408,0.00004
Sulfurospirillum cavolei,366522,S,364,8,372,0.00004
Actinobacillus succinogenes,67854,S,82,1,83,0.00001
Fluoribacter dumoffii,463,S,35,15,50,0
Neisseria polysaccharea,489,S,187,338,525,0.00005
Neisseria mucosa,488,S,411,1113,1524,0.00015
Neisseria meningitidis,487,S,1985,4660,6645,0.00065
Neisseria lactamica,486,S,717,984,1701,0.00017
Neisseria gonorrhoeae,485,S,510,2891,3401,0.00034
Neisseria cinerea,483,S,340,187,527,0.00005
Halomonas chromatireducens,507626,S,195,3,198,0.00002
Moraxella catarrhalis,480,S,1081,19,1100,0.00011
endosymbiont of Acanthamoeba sp. UWC8,86106,S,16,0,16,0
Corynebacterium casei,160386,S,113,20,133,0.00001
Sphingomonas wittichii,160791,S,2617,1689,4306,0.00042
Plantactinospora sp. BC1,2108470,S,40,96,136,0.00001
Leisingera methylohalidivorans,133924,S,690,77,767,0.00008
Olsenella uli,133926,S,321,12,333,0.00003
Paenibacillus borealis,160799,S,38,8,46,0
Microbacterium sp. 1.5R,1916917,S,126,641,767,0.00008
Treponema sp. OMZ 838,1539298,S,105,4,109,0.00001
Cryptobacterium curtum,84163,S,68,0,68,0.00001
Staphylococcus phage StB27,1147044,S,178,2,180,0.00002
cyanobacterium endosymbiont of Epithemia turgida,718217,S,48,12,60,0.00001
Acinetobacter larvae,1789224,S,813,8,821,0.00008
Halomonas sp. HL-93,1666906,S,54,395,449,0.00004
Methylocaldum marinum,1432792,S,626,13,639,0.00006
Aureimonas sp. AU20,1349819,S,842,55,897,0.00009
Pseudomonas sp. K2W31S-8,2320867,S,1167,38,1205,0.00012
Kineococcus radiotolerans,131568,S,341,47,388,0.00004
Klebsiella virus KP15,1985337,S,62,54,116,0.00001
Methylotenera mobilis,359408,S,189,16,205,0.00002
Acholeplasma oculi,35623,S,27,6,33,0
Klebsiella virus KP27,1985338,S,47,42,89,0.00001
Klebsiella virus Matisse,1985339,S,37,30,67,0.00001
Streptococcus phage YMC-2011,1051631,S,15,10,25,0
Niastella koreensis,354356,S,73,12,85,0.00001
Lactococcus virus ASCC191,1165134,S,134,42,176,0.00002
Desulfotomaculum nigrificans,1565,S,45,7,52,0.00001
Oceanimonas sp. GK1,511062,S,305,8,313,0.00003
Pseudoalteromonas espejiana,28107,S,38,6,44,0
Mesorhizobium huakuii,28104,S,128,626,754,0.00007
Burkholderia multivorans,87883,S,1366,562,1928,0.00019
Komagataeibacter medellinensis,1177712,S,120,50,170,0.00002
Sulfurovum lithotrophicum,206403,S,19,8,27,0
Alteromonas macleodii,28108,S,107,55,162,0.00002
Pseudoalteromonas nigrifaciens,28109,S,13,65,78,0.00001
Variovorax boronicumulans,436515,S,6076,2961,9037,0.00089
Shewanella violacea,60217,S,27,1,28,0
Stenotrophomonas phage IME15,1239382,S,14,0,14,0
Sulfurospirillum sp. JPD-1,220622,S,73,36,109,0.00001
Acetobacterium sp. KB-1,2184575,S,3272,266,3538,0.00035
Alcaligenes aquatilis,323284,S,116,181,297,0.00003
Blautia sp. YL58,1796616,S,45,3523,3568,0.00035
Shewanella denitrificans,192073,S,45,1,46,0
Bacteroides caecimuris,1796613,S,2069,288,2357,0.00023
Mucilaginibacter mallensis,652787,S,33,5,38,0
Thauera hydrothermalis,2184083,S,881,2502,3383,0.00033
Chlamydia suis,83559,S,13,178,191,0.00002
Serratia sp. JKS000199,1938820,S,34,204,238,0.00002
Hymenobacter sp. sh-6,2319843,S,92,5,97,0.00001
Bradyrhizobium sp. G22,1839752,S,164,251,415,0.00004
Escherichia phage ECML-117,1204521,S,38,0,38,0
Microbacterium sp. LKL04,912630,S,1319,215,1534,0.00015
Tenacibaculum dicentrarchi,669041,S,197,32,229,0.00002
Streptococcus pluranimalium,82348,S,2102,102,2204,0.00022
Sediminicola sp. YIK13,1453352,S,55,1,56,0.00001
Corynebacterium striatum,43770,S,111,43,154,0.00002
Corynebacterium urealyticum,43771,S,166,97,263,0.00003
Bacillus clausii,79880,S,64,2,66,0.00001
Bacillus horikoshii,79883,S,35,1,36,0
Arcanobacterium haemolyticum,28264,S,92,48,140,0.00001
Campylobacter concisus,199,S,70,1,71,0.00001
Campylobacter hyointestinalis,198,S,17,0,17,0
Campylobacter coli,195,S,436,152,588,0.00006
Campylobacter jejuni,197,S,1209,1047,2256,0.00022
Campylobacter fetus,196,S,34,0,34,0
Azospirillum lipoferum,193,S,765,350,1115,0.00011
Azospirillum brasilense,192,S,870,576,1446,0.00014
Tepidanaerobacter acetatoxydans,499229,S,97,0,97,0.00001
Rhodococcus aetherivorans,191292,S,54,126,180,0.00002
Methylobacterium sp. AMS5,925818,S,221,157,378,0.00004
Streptococcus sp. I-P16,1156433,S,685,371,1056,0.0001
Erwinia phage vB_EamM_Caitlin,1883379,S,335,6,341,0.00003
Streptococcus sp. I-G2,1156431,S,671,373,1044,0.0001
Melioribacter roseus,1134405,S,46,2,48,0
Staphylococcus argenteus,985002,S,24,2,26,0
Actinopolymorpha singaporensis,117157,S,278,16,294,0.00003
Luteimonas sp. 83-4,2172536,S,26562,3478,30040,0.00296
Halobacteroides halobius,42422,S,117,0,117,0.00001
Flavobacterium commune,1306519,S,700,36,736,0.00007
Mesorhizobium oceanicum,1670800,S,1097,128,1225,0.00012
Aquimarina sp. BL5,1714860,S,121,7,128,0.00001
Clostridium tyrobutyricum,1519,S,262,3,265,0.00003
Enterococcus phage IME-EFm5,1718158,S,17,0,17,0
Salinigranum rubrum,755307,S,30,6,36,0
Pelodictyon luteolum,1100,S,55,3,58,0.00001
Thiomonas arsenitoxydans,426114,S,873,325,1198,0.00012
Streptomyces davaonensis,348043,S,118,10,128,0.00001
Methylobacterium sp. 4-46,426117,S,763,56,819,0.00008
Rhodobacteraceae bacterium,1904441,S,150,204,354,0.00003
Delftia sp. Cs1-4,742013,S,1312,3960,5272,0.00052
Flavobacterium sp. HYN0086,2249356,S,540,66,606,0.00006
Paraburkholderia sprentiae,948107,S,313,70,383,0.00004
Jeotgalicoccus saudimassiliensis,1461582,S,27,0,27,0
Pseudomonas simiae,321846,S,156,753,909,0.00009
Sideroxydans lithotrophicus,63745,S,463,33,496,0.00005
Bacillus sp. Y1,352858,S,40,2,42,0
Lachnoanaerobaculum umeaense,617123,S,336,8,344,0.00003
Thermoanaerobacterium thermosaccharolyticum,1517,S,72,44,116,0.00001
Alteromonas australica,589873,S,45,9,54,0.00001
Ketobacter alkanivorans,1917421,S,126,14,140,0.00001
Desulfovibrio piger,901,S,4713,125,4838,0.00048
Salinicola tamaricis,1771309,S,251,10,261,0.00003
Lactococcus virus KSY1,388452,S,12,0,12,0
Acidaminococcus fermentans,905,S,686,182,868,0.00009
Nostoc sp. NIES-4103,2005458,S,42,7,49,0
Bradyrhizobium diazoefficiens,1355477,S,855,505,1360,0.00013
Corynebacterium provencense,1737425,S,155,9,164,0.00002
Streptomyces spongiicola,1690221,S,98,11,109,0.00001
Dickeya sp. MK7,1224145,S,11,6,17,0
Dickeya sp. CSL RW240,1224144,S,18,76,94,0.00001
Mucinivorans hirudinis,1433126,S,76,0,76,0.00001
Methanobacterium formicicum,2162,S,593,36,629,0.00006
Candidatus Ishikawaella capsulata,168169,S,13,0,13,0
Burkholderia diffusa,488732,S,91,45,136,0.00001
Gibbsiella quercinecans,929813,S,316,4,320,0.00003
Brachybacterium sp. VM2412,2017484,S,181,89,270,0.00003
Marinobacter sp. es.042,1761794,S,101,39,140,0.00001
Veillonella rodentium,248315,S,328,31,359,0.00004
Streptomyces globisporus,1908,S,112,44,156,0.00002
Ralstonia insidiosa,190721,S,1391,361,1752,0.00017
Streptomyces glaucescens,1907,S,105,14,119,0.00001
Sedimenticola thiotaurini,1543721,S,220,2,222,0.00002
Streptomyces clavuligerus,1901,S,111,13,124,0.00001
Nitratifractor salsuginis,269261,S,50,0,50,0
Lactococcus phage phiL47,1412875,S,138,116,254,0.00003
Kocuria sp. BT304,1702043,S,449,1153,1602,0.00016
Fusobacterium mortiferum,850,S,326,28,354,0.00003
Fusobacterium nucleatum,851,S,802,351,1153,0.00011
Beutenbergia cavernae,84757,S,430,31,461,0.00005
Faecalibacterium prausnitzii,853,S,594087,50328,644415,0.06351
Fusobacterium necrophorum,859,S,143,10,153,0.00002
gamma proteobacterium HdN1,83406,S,725,10,735,0.00007
Parascardovia denticolens,78258,S,171,1,172,0.00002
Thermococcus nautili,195522,S,10,13,23,0
Dickeya sp. DW 0440,1225785,S,98,649,747,0.00007
Clostridium phage c-st,12336,S,30,0,30,0
Mycoplasma bovoculi,45362,S,10,0,10,0
Herbaspirillum hiltneri,341045,S,586,60,646,0.00006
Trichormus variabilis,264691,S,12,21,33,0
Bacillus muralis,264697,S,40,1,41,0
Selenomonas sp. oral taxon 920,1884263,S,122,11,133,0.00001
Citrobacter youngae,133448,S,642,1082,1724,0.00017
Ferrimonas balearica,44012,S,267,6,273,0.00003
Paenibacillus stellifer,169760,S,128,9,137,0.00001
Elizabethkingia anophelis,1117645,S,3277,2690,5967,0.00059
Pontibacter akesuensis,388950,S,50,10,60,0.00001
Clostridium sp. JN500901,2068654,S,103,0,103,0.00001
Salmonella virus LSPA1,2005698,S,90,3,93,0.00001
Escherichia phage Lw1,1307804,S,34,16,50,0
Prevotella fusca,589436,S,93,38,131,0.00001
Verrucosispora maris,1003110,S,130,46,176,0.00002
Corynebacterium aquilae,203263,S,96,4,100,0.00001
Streptomyces nigra,1827580,S,122,15,137,0.00001
Alcanivorax borkumensis,59754,S,25,90,115,0.00001
Caldicellulosiruptor obsidiansis,717609,S,10,5,15,0
Catenulispora acidiphila,304895,S,340,24,364,0.00004
Kushneria marisflavi,157779,S,145,27,172,0.00002
Mycoplasma phocidae,142651,S,13,1,14,0
Microbulbifer thermotolerans,252514,S,138,2,140,0.00001
Paracoccus sp. SC2-6,2259340,S,1931,281,2212,0.00022
Sphingobium indicum,332055,S,261,617,878,0.00009
Sphingobium japonicum,332056,S,463,886,1349,0.00013
Burkholderia thailandensis,57975,S,182,492,674,0.00007
Mordavella sp. Marseille-P3756,2086584,S,5217,497,5714,0.00056
Brevibacillus formosus,54913,S,31,20,51,0.00001
Sphingobacterium sp. 21,743722,S,56,2,58,0.00001
Bradyrhizobiaceae bacterium SG-6C,709797,S,3884,782,4666,0.00046
Brachyspira intermedia,84377,S,18,5,23,0
Snodgrassella alvi,1196083,S,354,29,383,0.00004
Streptococcus phage phiNJ2,1239381,S,29,0,29,0
Deinococcus peraridilitoris,432329,S,98,1,99,0.00001
Pseudomonas moraviensis,321662,S,1594,436,2030,0.0002
Actinopolyspora erythraea,414996,S,167,6,173,0.00002
Halomonas sp. 1513,1883416,S,308,11,319,0.00003
Hippea maritima,84405,S,12,0,12,0
Terriglobus saanensis,870903,S,63,10,73,0.00001
Brucella sp. 09RB8910,1844051,S,124,71,195,0.00002
Macrococcus canis,1855823,S,116,21,137,0.00001
Pasteurella multocida,747,S,340,1009,1349,0.00013
Janthinobacterium sp. Marseille,375286,S,1337,275,1612,0.00016
Rathayibacter tritici,33888,S,390,49,439,0.00004
Geitlerinema sp. PCC 7407,1173025,S,64,7,71,0.00001
Pseudomonas entomophila,312306,S,494,44,538,0.00005
Neisseria subflava,28449,S,1486,298,1784,0.00018
Yersinia entomophaga,935293,S,113,3,116,0.00001
Clavibacter michiganensis,28447,S,1387,152,1539,0.00015
Anaerotignum propionicum,28446,S,365,0,365,0.00004
Capnocytophaga stomatis,1848904,S,102,15,117,0.00001
Salmonella virus SETP13,2005694,S,18,7,25,0
Muricauda lutaonensis,516051,S,19,0,19,0
Rhodococcus sp. B7740,1564114,S,335,25,360,0.00004
Streptacidiphilus sp. DSM 106435,2126346,S,175,35,210,0.00002
Pseudomonas rhizosphaerae,216142,S,1252,50,1302,0.00013
Bacillus safensis,561879,S,66,10,76,0.00001
Halorhodospira halochloris,1052,S,61,0,61,0.00001
Halorhodospira halophila,1053,S,191,6,197,0.00002
Shigella virus PSf2,1921005,S,10,2,12,0
Erwinia sp. Ejp617,215689,S,15,43,58,0.00001
Escherichia virus T1,1921008,S,11,1,12,0
Neomicrococcus aestuarii,556325,S,122,18,140,0.00001
Candidatus Kuenenia stuttgartiensis,174633,S,35,0,35,0
Corynebacterium ammoniagenes,1697,S,68,5,73,0.00001
Bifidobacterium pseudolongum,1694,S,653,21,674,0.00007
Bacillus sp. FJAT-22090,1581038,S,36,2,38,0
Anaeromyxobacter sp. K,447217,S,49,130,179,0.00002
Kibdelosporangium phytohabitans,860235,S,282,24,306,0.00003
Mesorhizobium amorphae,71433,S,1010,158,1168,0.00012
Streptomyces sp. CdTB01,1725411,S,169,17,186,0.00002
Leptospirillum ferriphilum,178606,S,18,29,47,0
Marinithermus hydrothermalis,186192,S,60,9,69,0.00001
Mycolicibacterium aurum,1791,S,1538,254,1792,0.00018
Streptomyces griseochromogenes,68214,S,114,10,124,0.00001
Paenibacillus donghaensis,414771,S,94,5,99,0.00001
Halomonas hydrothermalis,115561,S,298,20,318,0.00003
Clostridium isatidis,182773,S,220,13,233,0.00002
Paraburkholderia hospita,169430,S,358,217,575,0.00006
Dokdonia sp. 4H-3-7-5,983548,S,18,8,26,0
Micrococcus luteus,1270,S,2784,903,3687,0.00036
Planococcus donghaensis,414778,S,29,6,35,0
Dermacoccus nishinomiyaensis,1274,S,1151,237,1388,0.00014
Serratia liquefaciens,614,S,1964,122,2086,0.00021
Serratia marcescens,615,S,2262,1274,3536,0.00035
Luteitalea pratensis,1855912,S,397,1,398,0.00004
Enterobacteria phage phiEcoM-GJ1,451705,S,205,0,205,0.00002
Methanocella conradii,1175444,S,19,0,19,0
Thauera aromatica,59405,S,4808,2507,7315,0.00072
Acidovorax ebreus,721785,S,8003,38369,46372,0.00457
Erythrobacter flavus,192812,S,341,232,573,0.00006
Pectobacterium phage PM1,1399915,S,23,0,23,0
Pantoea stewartii,66269,S,227,7,234,0.00002
Mycoplasma gallisepticum,2096,S,63,10,73,0.00001
Streptomyces sp. ETH9427,2211357,S,84,11,95,0.00001
Desulfuromonas soudanensis,1603606,S,211,13,224,0.00002
Virgibacillus pantothenticus,1473,S,29,1,30,0
Geobacillus subterraneus,129338,S,16,8,24,0
Bacillus methanolicus,1471,S,52,3,55,0.00001
Methylobacterium sp. 17Sr1-28,2202827,S,416,79,495,0.00005
Methylobacterium sp. 17Sr1-1,2202826,S,390,79,469,0.00005
Methylobacterium sp. 17SD2-17,2202825,S,529,40,569,0.00006
Enterobacter ludwigii,299767,S,194,311,505,0.00005
Bacillus simplex,1478,S,52,3,55,0.00001
Methylobacterium sp. 17Sr1-43,2202828,S,1075,111,1186,0.00012
Marinobacter sp. LQ44,1749259,S,114,21,135,0.00001
Methanobacterium sp. MZ-A1,1911685,S,20,110,130,0.00001
Altererythrobacter atlanticus,1267766,S,555,312,867,0.00009
Streptococcus sanguinis,1305,S,2364,87,2451,0.00024
Campylobacter sp. RM16704,1500960,S,19,0,19,0
Bibersteinia trehalosi,47735,S,94,21,115,0.00001
Streptococcus gordonii,1302,S,3470,171,3641,0.00036
Chelativorans sp. BNC1,266779,S,1105,79,1184,0.00012
Candidatus Tachikawaea gelatinosa,1410383,S,12,0,12,0
Streptococcus thermophilus,1308,S,67314,15025,82339,0.00812
Citrobacter amalonaticus,35703,S,983,442,1425,0.00014
Brevirhabdus pacifica,1267768,S,980,456,1436,0.00014
Geobacter daltonii,1203471,S,88,2,90,0.00001
Aeromonas aquatica,558964,S,275,245,520,0.00005
Enterobacter cloacae complex sp. FDA-CDC-AR_0132,2077137,S,233,393,626,0.00006
Enterobacter cloacae complex sp. FDA-CDC-AR_0164,2077136,S,203,355,558,0.00005
Stenotrophomonas sp. ESTM1D_MKCIP4_1,2072414,S,1237,434,1671,0.00016
Stenotrophomonas sp. SAU14A_NAIMI4_5,2072413,S,861,495,1356,0.00013
Stenotrophomonas sp. ZAC14A_NAIMI4_1,2072412,S,335,669,1004,0.0001
Shewanella putrefaciens,24,S,56,68,124,0.00001
Clostridium estertheticum,238834,S,176,3,179,0.00002
Lactobacillus ginsenosidimutans,1007676,S,1535,11,1546,0.00015
Stenotrophomonas sp. MYb57,1827305,S,668,784,1452,0.00014
Pseudomonas sp. MYb193,1827300,S,27778,9525,37303,0.00368
Brevundimonas sp. DS20,1532555,S,7968,2185,10153,0.001
Pseudomonas virus Yua,462590,S,12,4,16,0
Burkholderia insecticola,758793,S,377,28,405,0.00004
Deinococcus deserti,310783,S,91,4,95,0.00001
Rhodococcus virus Pepy6,1982368,S,12,5,17,0
Delftia sp. HK171,1920191,S,1280,4262,5542,0.00055
Flavobacteriaceae bacterium 3519-10,531844,S,1327,32,1359,0.00013
Cronobacter phage vB_CsaM_GAP32,1141136,S,35,0,35,0
Methanobrevibacter ruminantium,83816,S,36,0,36,0
Arthrobacter sp. PGP41,2079227,S,119,12,131,0.00001
Paraburkholderia aromaticivorans,2026199,S,330,149,479,0.00005
Erythrobacter gangjinensis,502682,S,282,8,290,0.00003
Synechococcus sp. PCC 6312,195253,S,41,1,42,0
Paenibacillus xylanexedens,528191,S,54,3,57,0.00001
Paenisporosarcina sp. K2R23-3,2320858,S,30,5,35,0
Flammeovirgaceae bacterium 311,1257021,S,48,1,49,0
Sphingomonas sp. KC8,1030157,S,931,22,953,0.00009
Planococcus antarcticus,161360,S,29,2,31,0
Methylobacterium radiotolerans,31998,S,177,536,713,0.00007
Streptomyces sp. NEAU-S7GS2,2202000,S,108,10,118,0.00001
Comamonas kerstersii,225992,S,14153,2696,16849,0.00166
Enterobacteriaceae bacterium w6,2282310,S,215,37,252,0.00002
Lactococcus phage 340,1262533,S,103,67,170,0.00002
Paenibacillus bovis,1616788,S,149,11,160,0.00002
Achromobacter ruhlandii,72557,S,149,2407,2556,0.00025
Citrobacter phage Margaery,1701810,S,32,7,39,0
Paenibacillus crassostreae,1763538,S,26,2,28,0
Candidatus Methylopumilus planktonicus,1581557,S,40,2,42,0
Flavobacterium crassostreae,1763534,S,773,61,834,0.00008
Hydrogenophaga crassostreae,1763535,S,6986,256,7242,0.00071
Thalassotalea crassostreae,1763536,S,23,0,23,0
Lactobacillus sp. CBA3605,2099788,S,26,1,27,0
Lactobacillus sp. CBA3606,2099789,S,42,5,47,0
Prevotella intermedia,28131,S,613,166,779,0.00008
Auraticoccus monumenti,675864,S,565,44,609,0.00006
Psychromicrobium lacuslunae,1618207,S,98,2,100,0.00001
Gluconobacter albidus,318683,S,92,27,119,0.00001
Ruegeria sp. NKC1-1,2099786,S,43,0,43,0
Salmonella phage IME207,1873985,S,57,12,69,0.00001
Acinetobacter phage Acj9,760939,S,23,0,23,0
Deinococcus soli Cha et al. 2016,1309411,S,52,56,108,0.00001
Paracoccus sp. CBA4604,2065379,S,6060,552,6612,0.00065
Kordia sp. SMS9,2282170,S,147,2,149,0.00001
Micromonospora coxensis,356852,S,110,49,159,0.00002
Micromonospora chokoriensis,356851,S,115,26,141,0.00001
Mycobacterium sp. VKM Ac-1817D,1273687,S,462,2491,2953,0.00029
Cronobacter malonaticus,413503,S,184,294,478,0.00005
Cronobacter turicensis,413502,S,166,23,189,0.00002
Cronobacter muytjensii,413501,S,276,32,308,0.00003
Enterobacter bugandensis,881260,S,519,69,588,0.00006
Acetobacter ghanensis,431306,S,82,9,91,0.00001
Moorea producens,1155739,S,99,0,99,0.00001
Leptospira borgpetersenii,174,S,15,4,19,0
Syntrophobotulus glycolicus,51197,S,381,3,384,0.00004
Croceibacter atlanticus,313588,S,100,5,105,0.00001
Microterricola viridarii,412690,S,1003,153,1156,0.00011
Klebsiella virus KP34,1920777,S,70,16,86,0.00001
Azorhizobium caulinodans,7,S,1740,198,1938,0.00019
Comamonas serinivorans,1082851,S,8806,841,9647,0.00095
Klebsiella virus SU552A,1920779,S,20,4,24,0
Klebsiella virus SU503,1920778,S,21,4,25,0
Candidatus Gracilibacteria bacterium HOT-871,1540872,S,53,0,53,0.00001
Mucilaginibacter paludis,423351,S,81,4,85,0.00001
Proteiniphilum saccharofermentans,1642647,S,285,10,295,0.00003
Corynebacterium glyciniphilum,1404244,S,130,6,136,0.00001
Elusimicrobium minutum,423605,S,27,0,27,0
Vibrio anguillarum,55601,S,104,30,134,0.00001
Paracoccus contaminans,1945662,S,3851,482,4333,0.00043
Pseudomonas knackmussii,65741,S,939,303,1242,0.00012
Erysipelothrix larvae,1514105,S,1077,48,1125,0.00011
Microvirga ossetica,1882682,S,944,65,1009,0.0001
Nitrosomonas sp. Is79A3,261292,S,165,4,169,0.00002
Escherichia virus G7C,1920754,S,278,22,300,0.00003
Nostoc sp. 'Lobaria pulmonaria (5183) cyanobiont',1618022,S,17,7,24,0
Bradyrhizobium sp. ORS 278,114615,S,643,120,763,0.00008
Jeongeupia sp. USM3,1906741,S,1065,87,1152,0.00011
Microbacterium sp. BH-3-3-3,1906742,S,1258,201,1459,0.00014
Methylobacterium nodulans,114616,S,794,43,837,0.00008
Fibrella sp. ES10-3-2-2,1834519,S,61,6,67,0.00001
Pseudomonas sp. XWY-1,2069256,S,113,201,314,0.00003
Pelosinus sp. UFO1,484770,S,226,185,411,0.00004
Microcoleus sp. PCC 7113,1173027,S,28,2,30,0
Brochothrix phage BL3,764562,S,15,0,15,0
Desulfurobacterium thermolithotrophum,64160,S,11,1,12,0
Paraburkholderia rhizoxinica,412963,S,245,8,253,0.00002
Caulobacter mirabilis,69666,S,1525,171,1696,0.00017
Lactobacillus amylovorus,1604,S,6974,600,7574,0.00075
Xylella fastidiosa,2371,S,340,40,380,0.00004
Salmonella virus SP31,1911006,S,23,0,23,0
Celeribacter marinus,1397108,S,212,8,220,0.00002
Candidatus Protochlamydia amoebophila,362787,S,20,2,22,0
Burkholderia oklahomensis,342113,S,125,38,163,0.00002
Spiroplasma cantharicola,362837,S,11,2,13,0
Pseudodesulfovibrio piezophilus,879567,S,65,1,66,0.00001
Lactobacillus parabuchneri,152331,S,870,58,928,0.00009
Sphingopyxis fribergensis,1515612,S,5944,1234,7178,0.00071
Micromonospora echinospora,1877,S,154,30,184,0.00002
Cronobacter phage CR5,1195085,S,135,22,157,0.00002
Methanothermobacter thermautotrophicus,145262,S,12,13,25,0
Prosthecochloris sp. GSB1,281093,S,70,2,72,0.00001
Psychrobacter alimentarius,261164,S,13289,510,13799,0.00136
Aeromonas phage CC2,1204516,S,11,0,11,0
Streptococcus merionis,400065,S,751,7,758,0.00007
Selenomonas ruminantium,971,S,562,50,612,0.00006
Streptomyces formicae,1616117,S,146,11,157,0.00002
Escherichia phage APCEc01,1655305,S,11,30,41,0
Escherichia phage slur16,1720495,S,342,135,477,0.00005
Mitsuaria sp. 7,1658665,S,1819,321,2140,0.00021
Lutibacter profundi,1622118,S,124,3,127,0.00001
Cellulophaga lytica,979,S,137,17,154,0.00002
Stackebrandtia nassauensis,283811,S,213,5,218,0.00002
Gilvibacter sp. SZ-19,754429,S,37,2,39,0
Leptospirillum ferrooxidans,180,S,15,0,15,0
Castellaniella defragrans,75697,S,1579,279,1858,0.00018
Rufibacter sp. DG31D,1379910,S,47,3,50,0
Methylobacterium aquaticum,270351,S,687,123,810,0.00008
Tenacibaculum sp. SZ-18,754423,S,232,15,247,0.00002
Pseudomonas sp. St29,1500687,S,112,153,265,0.00003
Pseudomonas sp. Os17,1500686,S,105,143,248,0.00002
Halopiger xanaduensis,387343,S,24,2,26,0
Burkholderia metallica,488729,S,142,64,206,0.00002
Methylobacterium sp. XJLM,1826873,S,101,1057,1158,0.00011
Rhodobacter sp. CZR27,2033869,S,1740,456,2196,0.00022
Microcystis aeruginosa,1126,S,61,16,77,0.00001
Thermogutta terrifontis,1331910,S,43,0,43,0
Methylacidiphilum fumariolicum,591154,S,10,4,14,0
Streptomyces griseus,1911,S,68,23,91,0.00001
Pseudomonas sp. Lz4W,1206777,S,5813,11100,16913,0.00167
Streptomyces lincolnensis,1915,S,172,15,187,0.00002
Streptomyces lavendulae,1914,S,111,13,124,0.00001
Bordetella pseudohinzii,1331258,S,722,151,873,0.00009
Terriglobus roseus,392734,S,173,24,197,0.00002
Pseudomonas phage PaBG,1335230,S,80,0,80,0.00001
Frischella perrara,1267021,S,32,0,32,0
Paraburkholderia caribensis,75105,S,471,156,627,0.00006
Syntrophomonas wolfei,863,S,116,2,118,0.00001
Caldanaerobacter subterraneus,911092,S,58,20,78,0.00001
Mycoplasma fermentans,2115,S,15,0,15,0
Brochothrix thermosphacta,2756,S,833,46,879,0.00009
Achromobacter xylosoxidans,85698,S,4281,2509,6790,0.00067
Thermomonospora curvata,2020,S,277,54,331,0.00003
Thermobifida fusca,2021,S,131,8,139,0.00001
Acinetobacter sp. ADP1,62977,S,1171,26,1197,0.00012
Carnobacterium maltaromaticum,2751,S,8720,968,9688,0.00095
Bacillus cellulasensis,1049581,S,102,126,228,0.00002
Sphingomonas melonis,152682,S,1814,2661,4475,0.00044
Agromyces sp. 30A,2080742,S,669,160,829,0.00008
Corynebacterium sp. 2183,2080740,S,100,4,104,0.00001
Clostridium perfringens,1502,S,1516,29,1545,0.00015
Desulfovibrio vulgaris,881,S,1863,15,1878,0.00019
Desulfovibrio salexigens,880,S,118,2,120,0.00001
Rhodococcus sp. PBTS 2,1653479,S,1508,663,2171,0.00021
Rhodococcus sp. PBTS 1,1653478,S,352,48,400,0.00004
Nakamurella multipartita,53461,S,17619,1428,19047,0.00188
Magnetospirillum sp. ME-1,1639348,S,272,153,425,0.00004
Klebsiella virus K11,1985724,S,14,5,19,0
Paenibacillus terrae,159743,S,45,7,52,0.00001
Candidatus Phytoplasma australiense,59748,S,11,2,13,0
Escherichia virus ECB2,1987939,S,41,2,43,0
Enterobacteria phage EcoDS1,532075,S,24,13,37,0
Jannaschia sp. CCS1,290400,S,372,4,376,0.00004
Escherichia virus EPS7,491003,S,45,36,81,0.00001
Klebsiella phage vB_KpnM_KpV477,1852625,S,106,13,119,0.00001
Mesotoga prima,1184387,S,3588,1,3589,0.00035
Streptomyces sp. SCSIO 03032,1109743,S,219,18,237,0.00002
Sphingobacterium sp. B29,1933220,S,123,50,173,0.00002
Rickettsiales bacterium Ac37b,1528098,S,42,1,43,0
Lawsonella clevelandensis,1528099,S,128,10,138,0.00001
Algoriphagus machipongonensis,388413,S,58,0,58,0.00001
Bacteroides ovatus,28116,S,2071,75,2146,0.00021
Spongiibacter sp. IMCC21906,1620392,S,84,3,87,0.00001
Azoarcus olearius,418699,S,401,1125,1526,0.00015
Azospirillum thiophilum,528244,S,1278,301,1579,0.00016
Streptomyces cyaneogriseus,68192,S,48,12,60,0.00001
Croceicoccus marinus,450378,S,610,289,899,0.00009
Pseudomonas sp. LH1G9,2083055,S,2687,2526,5213,0.00051
Pseudomonas sp. LG1D9,2083054,S,3315,464,3779,0.00037
Pseudomonas sp. SWI44,2083053,S,63,255,318,0.00003
Pseudomonas sp. SWI36,2083052,S,46,94,140,0.00001
Pseudomonas sp. SWI6,2083051,S,26,174,200,0.00002
Pseudomonas brassicacearum,930166,S,709,1736,2445,0.00024
Massilia sp. NR 4-1,1678028,S,1176,124,1300,0.00013
Pediococcus inopinatus,114090,S,172,36,208,0.00002
Ehrlichia ruminantium,779,S,42,0,42,0
Klebsiella phage phiKO2,255431,S,11,1,12,0
Candidatus Nitrospira inopinata,1715989,S,61,0,61,0.00001
Escherichia phage PE3-1,1498170,S,17,7,24,0
Methanosarcina siciliae,38027,S,24,3,27,0
Vibrio shilonii,62153,S,20,0,20,0
Simonsiella muelleri,72,S,655,97,752,0.00007
Bacteroides phage B124-14,1105171,S,63,7,70,0.00001
Burkholderia pseudomallei,28450,S,559,2527,3086,0.0003
Streptomyces avermitilis,33903,S,122,10,132,0.00001
Verminephrobacter eiseniae,364317,S,11648,368,12016,0.00118
Chamaesiphon minutus,1173032,S,32,1,33,0
Candidatus Nitrosoglobus terrae,1630141,S,36,2,38,0
Pectobacterium atrosepticum,29471,S,256,27,283,0.00003
Megamonas hypermegale,158847,S,735,44,779,0.00008
Streptomyces katrae,68223,S,76,10,86,0.00001
Leminorella richardii,158841,S,125,1,126,0.00001
Micromonospora echinofusca,47858,S,194,66,260,0.00003
Candidatus Thioglobus singularis,1427364,S,42,2,44,0
Synechococcus sp. NIES-970,1827144,S,15,2,17,0
Allochromatium vinosum,1049,S,350,49,399,0.00004
Streptomyces fulvissimus,68202,S,51,16,67,0.00001
Veillonella parvula,29466,S,4973,301,5274,0.00052
Bifidobacterium bifidum,1681,S,25217,1868,27085,0.00267
Bifidobacterium adolescentis,1680,S,153811,6851,160662,0.01583
Bifidobacterium angulatum,1683,S,3403,109,3512,0.00035
Bifidobacterium breve,1685,S,3814,863,4677,0.00046
Bifidobacterium asteroides,1684,S,179,-179,0,0
Bifidobacterium coryneforme,1687,S,27,8,35,0
Bifidobacterium catenulatum,1686,S,15206,3088,18294,0.0018
Bifidobacterium dentium,1689,S,3808,15,3823,0.00038
Enterobacter sp. R4-368,1166130,S,318,20,338,0.00003
Lactobacillus curvatus,28038,S,424,43,467,0.00005
Anaerococcus mediterraneensis,1870984,S,56,6,62,0.00001
Ignavibacterium album,591197,S,88,7,95,0.00001
Natranaerobius thermophilus,375929,S,39,0,39,0
Vibrio harveyi,669,S,57,10,67,0.00001
Aliivibrio fischeri,668,S,46,2,48,0
Paracoccus aminophilus,34003,S,3526,170,3696,0.00036
Paenibacillus physcomitrellae,1619311,S,87,22,109,0.00001
Vibrio alginolyticus,663,S,289,57,346,0.00003
Paracoccus aminovorans,34004,S,8339,1316,9655,0.00095
Ruminococcus albus,1264,S,270,2,272,0.00003
Collimonas pratensis,279113,S,596,151,747,0.00007
Pseudomonas sp. S09G 359,2054919,S,1133,158,1291,0.00013
Sulfurimonas gotlandica,1176482,S,60,1,61,0.00001
Microbacterium paludicola,300019,S,1516,201,1717,0.00017
Micromonospora rifamycinica,291594,S,146,37,183,0.00002
Altererythrobacter dongtanensis,692370,S,357,30,387,0.00004
Aeromonas virus 25,233894,S,71,13,84,0.00001
Paenibacillus sabinae,365617,S,88,8,96,0.00001
Streptomyces hygroscopicus,1912,S,184,55,239,0.00002
Salinispira pacifica,1307761,S,34,0,34,0
Escherichia virus K1G,1911008,S,398,156,554,0.00005
Escherichia virus EC6,1965376,S,12,8,20,0
Sulfuricurvum kujiense,148813,S,35,0,35,0
Robiginitalea biformata,252307,S,36,0,36,0
Lactobacillus kunkeei,148814,S,49,0,49,0
Brevibacillus laterosporus,1465,S,118,8,126,0.00001
Paenibacillus larvae,1464,S,44,2,46,0
Bacillus lentus,1467,S,61,1,62,0.00001
Mycoplasma haemofelis,29501,S,15,0,15,0
Solimonas sp. K1W22B-7,2303331,S,602,4,606,0.00006
Bordetella avium,521,S,537,44,581,0.00006
Chlamydia sp. 2742-308,1806891,S,19,11,30,0
Streptococcus pyogenes,1314,S,1319,577,1896,0.00019
Streptococcus pneumoniae,1313,S,1978,944,2922,0.00029
Rathayibacter toxicus,145458,S,92,8,100,0.00001
Streptococcus agalactiae,1311,S,8021,10791,18812,0.00185
Streptococcus sobrinus,1310,S,1134,20,1154,0.00011
Pseudomonas brenneri,129817,S,1274,230,1504,0.00015
Asaia bogorensis,91915,S,101,3,104,0.00001
Acinetobacter defluvii,1871111,S,3530,632,4162,0.00041
Streptococcus sp. 'group B',1319,S,88,4697,4785,0.00047
Salmonella enterica,28901,S,4994,10247,15241,0.0015
Paeniclostridium sordellii,1505,S,538,13,551,0.00005
Stenotrophomonas sp. YAU14A_MKIMI4_1,2072408,S,101,696,797,0.00008
Stenotrophomonas sp. SAU14A_NAIMI4_8,2072409,S,109,752,861,0.00008
Salinivirga cyanobacteriivorans,1307839,S,30,0,30,0
Vibrio coralliilyticus,190893,S,117,3,120,0.00001
Oceanisphaera avium,1903694,S,89,3,92,0.00001
Stenotrophomonas sp. ZAC14D2_NAIMI4_6,2072406,S,321,666,987,0.0001
Stenotrophomonas sp. YAU14D1_LEIMI4_1,2072407,S,383,678,1061,0.0001
Vibrio rotiferianus,190895,S,31,5,36,0
Halomonas sp. N3-2A,2014541,S,57,27,84,0.00001
Alcanivorax sp. N3-2A,2014542,S,432,78,510,0.00005
Corynebacterium testudinoris,136857,S,187,13,200,0.00002
Sphingobacterium mizutaii,1010,S,252,15,267,0.00003
Phycisphaera mikurensis,547188,S,174,0,174,0.00002
Lactobacillus lindneri,53444,S,61,2,63,0.00001
Sodalis praecaptivus,1239307,S,81,65,146,0.00001
Amycolatopsis keratiniphila,129921,S,55,101,156,0.00002
Selenomonas sp. oral taxon 478,712538,S,64,156,220,0.00002
Halobiforma lacisalsi,229731,S,22,1,23,0
Fusobacterium periodonticum,860,S,391,90,481,0.00005
Paucibacter sp. KCTC 42545,1768242,S,3548,591,4139,0.00041
Desulfosporosinus meridiei,79209,S,64,6,70,0.00001
Corynebacterium sp. ATCC 6931,1487956,S,119,32,151,0.00001
Microlunatus soli,630515,S,466,14,480,0.00005
Pseudomonas mediterranea,183795,S,502,92,594,0.00006
Chelatococcus daeguensis,444444,S,546,267,813,0.00008
Sphingobium yanoikuyae,13690,S,5179,1178,6357,0.00063
Chromobacterium sp. ATCC 53434,2059672,S,485,101,586,0.00006
Pseudomonas syringae,317,S,2442,1919,4361,0.00043
Chromobacterium sp. IIBBL 274-1,2202142,S,108,806,914,0.00009
Enterobacteriaceae bacterium w17,2282309,S,193,55,248,0.00002
Rhodococcus sp. 2G,1570939,S,60,133,193,0.00002
Intrasporangium calvum,53358,S,683,91,774,0.00008
Pseudoarcobacter ellisii,913109,S,2536,572,3108,0.00031
Bacillus sp. X1(2014),1565991,S,112,14,126,0.00001
Salmonella virus FelixO1,1985310,S,25,21,46,0
Nitrosospira multiformis,1231,S,156,13,169,0.00002
Bacteroides coprosuis,151276,S,254,2,256,0.00003
Belliella baltica,232259,S,260,32,292,0.00003
Leuconostoc mesenteroides,1245,S,841,261,1102,0.00011
Cyanothece sp. PCC 7822,497965,S,63,12,75,0.00001
Streptococcus constellatus,76860,S,575,173,748,0.00007
Sphingobacteriaceae bacterium GW460-11-11-14-LB5,1986952,S,91,6,97,0.00001
Malacobacter mytili,603050,S,453,25,478,0.00005
Thiocystis violascens,73141,S,410,27,437,0.00004
Prevotella denticola,28129,S,152,51,203,0.00002
Serratia sp. FGI94,671990,S,97,29,126,0.00001
Gluconobacter oxydans,442,S,236,57,293,0.00003
Labrenzia aggregata,187304,S,127,205,332,0.00003
Methylocystis sp. SC2,187303,S,501,30,531,0.00005
Lactobacillus backii,375175,S,336,51,387,0.00004
Acinetobacter sp. ACNIH2,1758189,S,7041,732,7773,0.00077
Porphyromonas asaccharolytica,28123,S,66,1,67,0.00001
Methanolinea tarda,263906,S,17,0,17,0
Escherichia phage vB_EcoM_Alf5,1873990,S,20,15,35,0
Dietzia sp. JS16-p6b,2052657,S,246,50,296,0.00003
Collinsella aerofaciens,74426,S,75030,2961,77991,0.00769
Methanohalobium evestigatum,2322,S,13,0,13,0
Magnetococcus marinus,1124597,S,110,0,110,0.00001
Phaeobacter gallaeciensis,60890,S,736,433,1169,0.00012
Treponema pedis,409322,S,17,0,17,0
Desulfobacca acetoxidans,60893,S,57,0,57,0.00001
Achromobacter sp. MFA1 R4,1881016,S,863,134,997,0.0001
Pseudomonas sp. 7SR1,1881017,S,680,49,729,0.00007
Streptomyces sp. 3211,1964449,S,36,13,49,0
Winogradskyella sp. PC-19,754417,S,96,19,115,0.00001
Pseudomonas sp. S-6-2,1931241,S,397,4,401,0.00004
Rhizobium sp. 11515TR,2028343,S,1052,85,1137,0.00011
Entomoplasma melaleucae,81459,S,52,31,83,0.00001
Virgibacillus necropolis,163877,S,35,1,36,0
Thermobaculum terrenum,166501,S,42,0,42,0
Aeromonas dhakensis,196024,S,175,61,236,0.00002
Mogibacterium pumilum,86332,S,220,68,288,0.00003
Spirosoma aerolatum,1211326,S,100,4,104,0.00001
Shigella virus Sb1,1920761,S,120,9,129,0.00001
Solibacillus sp. R5-41,2048654,S,42,8,50,0
Rhodococcus sp. S2-17,1990687,S,280,26,306,0.00003
Hartmannibacter diazotrophicus,1482074,S,1435,134,1569,0.00015
archaeon AArc-Sl,2055893,S,15,1,16,0
Gordonia phage Vivi2,1821564,S,15,0,15,0
Jatrophihabitans sp. GAS493,1907575,S,167,26,193,0.00002
Caldicellulosiruptor hydrothermalis,413888,S,19,15,34,0
Lactobacillus paraplantarum,60520,S,70,2,72,0.00001
[Polyangium] brachysporum,413882,S,2448,312,2760,0.00027
Aurantimicrobium minutum,708131,S,44,15,59,0.00001
Lelliottia jeotgali,1907578,S,735,89,824,0.00008
Sodalis glossinidius,63612,S,148,9,157,0.00002
Crinalium epipsammum,241425,S,17,2,19,0
Hahella chejuensis,158327,S,149,5,154,0.00002
Dyadobacter fermentans,94254,S,113,4,117,0.00001
Thioflavicoccus mobilis,80679,S,383,27,410,0.00004
Gemmatirosa kalamazoonesis,861299,S,232,3,235,0.00002
Lelliottia sp. WB101,2153385,S,1093,125,1218,0.00012
Neisseria sp. 10023,1853278,S,4682,370,5052,0.0005
Calyptogena okutanii thioautotrophic gill symbiont,410330,S,27,6,33,0
endosymbiont of unidentified scaly snail isolate Monju,1248727,S,350,3,353,0.00003
Alteromonas sp. BL110,1714845,S,30,6,36,0
Aquimarina sp. AD1,1714848,S,85,5,90,0.00001
Aquimarina sp. AD10,1714849,S,121,3,124,0.00001
Plautia stali symbiont,891974,S,334,5,339,0.00003
Lactobacillales bacterium,1993866,S,56,0,56,0.00001
Neisseria sp. 10022,1853276,S,4261,300,4561,0.00045
Capnocytophaga sp. oral taxon 864,1316593,S,15,18,33,0
Candidatus Doolittlea endobia,1778262,S,27,0,27,0
Candidatus Hoaglandella endobia,1778263,S,17,0,17,0
Candidatus Mikella endobia,1778264,S,23,4,27,0
Fervidobacterium pennivorans,93466,S,18,4,22,0
Streptococcus lutetiensis,150055,S,1424,2803,4227,0.00042
Candidatus Protochlamydia naegleriophila,389348,S,132,21,153,0.00002
Anaeromyxobacter sp. Fw109-5,404589,S,288,19,307,0.00003
Aneurinibacillus sp. XH2,1450761,S,64,3,67,0.00001
Carboxydocella thermautotrophica,178899,S,78,0,78,0.00001
Gloeocapsa sp. PCC 7428,1173026,S,29,2,31,0
Candidatus Kinetoplastibacterium galatii,994695,S,11,4,15,0
Paracoccus sp. BM15,1529068,S,3261,123,3384,0.00033
Saccharospirillum mangrovi,2161747,S,179,8,187,0.00002
Vibrio casei,673372,S,422,39,461,0.00005
[Clostridium] ultunense,45497,S,183,3,186,0.00002
Candidatus Kinetoplastibacterium desouzaii,994692,S,17,4,21,0
Geodermatophilus obscurus,1861,S,337,68,405,0.00004
Dermatophilus congolensis,1863,S,129,4,133,0.00001
Ottowia sp. oral taxon 894,1658672,S,8186,382,8568,0.00084
Arsenicicoccus sp. oral taxon 190,1658671,S,781,214,995,0.0001
Streptomyces qaidamensis,1783515,S,106,10,116,0.00001
Rhodococcus hoagii,43767,S,433,83,516,0.00005
Campylobacter insulaenigrae,260714,S,20,0,20,0
Herbaspirillum seropedicae,964,S,1020,422,1442,0.00014
Microvirgula aerodenitrificans,57480,S,1109,99,1208,0.00012
Gordonia sp. KTR9,337191,S,1404,331,1735,0.00017
Phreatobacter cathodiphilus,1868589,S,1023,80,1103,0.00011
Streptococcus gallolyticus,315405,S,12321,7485,19806,0.00195
Candidatus Thiodictyon syntrophicum,1166950,S,841,29,870,0.00009
Myxococcus fulvus,33,S,242,179,421,0.00004
Neisseria zoodegmatis,326523,S,6740,732,7472,0.00074
Pseudomonas sabulinigri,472181,S,374,3,377,0.00004
Gordonia phage Cozz,1838066,S,15,0,15,0
Mycoplasma hyorhinis,2100,S,17,5,22,0
Mycoplasma pulmonis,2107,S,16,0,16,0
Lacunisphaera limnophila,1838286,S,525,96,621,0.00006
Escherichia virus ACGM12,1945565,S,27,2,29,0
Shewanella piezotolerans,404011,S,54,1,55,0.00001
Corynebacterium glaucum,187491,S,99,4,103,0.00001
Exiguobacterium sp. ZWU0009,1224749,S,14,47,61,0.00001
Fluviicola taffensis,191579,S,343,2,345,0.00003
Thermanaeromonas toyohensis,161154,S,27,0,27,0
Gemmatimonas phototrophica,1379270,S,93,6,99,0.00001
Clostridium drakei,332101,S,32,1,33,0
Rhodothermus marinus,29549,S,141,10,151,0.00001
Spirosoma pollinicola,2057025,S,75,4,79,0.00001
Sphingopyxis sp. WS5A3p,2054227,S,4565,1288,5853,0.00058
Desulfovibrio gigas,879,S,411,2,413,0.00004
Desulfovibrio desulfuricans,876,S,786,963,1749,0.00017
Sulfitobacter sp. JL08,2070369,S,343,15,358,0.00004
Desulfovibrio africanus,873,S,290,3,293,0.00003
Dichelobacter nodosus,870,S,784,84,868,0.00009
[Pseudomonas] mesoacidophila,265293,S,93,36,129,0.00001
Marinobacter hydrocarbonoclasticus,2743,S,318,52,370,0.00004
Microbacterium testaceum,2033,S,1071,123,1194,0.00012
Ralstonia mannitolilytica,105219,S,2539,1371,3910,0.00039
Halomonas elongata,2746,S,241,6,247,0.00002
Buchnera aphidicola,9,S,177,-42,135,0.00001
Beggiatoa leptomitoformis,288004,S,62,0,62,0.00001
Tropheryma whipplei,2039,S,11,0,11,0
Leuconostoc gelidum,1244,S,159,9,168,0.00002
Acinetobacter schindleri,108981,S,6575,1038,7613,0.00075
Gordonia sp. 1D,1737359,S,553,181,734,0.00007
Desulfococcus multivorans,897,S,373,34,407,0.00004
Desulfomicrobium baculatum,899,S,868,31,899,0.00009
Actinomadura amylolytica,1411117,S,287,72,359,0.00004
Escherichia virus C40,1914204,S,19,63,82,0.00001
Kosakonia sacchari,1158459,S,424,26,450,0.00004
Pusillimonas sp. T7-7,1007105,S,615,56,671,0.00007
Lactobacillus amylolyticus,83683,S,487,15,502,0.00005
Mesorhizobium ciceri,39645,S,1063,1019,2082,0.00021
Shigella virus Shfl2,1914205,S,11,29,40,0
Leptothrix cholodnii,34029,S,4260,872,5132,0.00051
Corynebacterium maris,575200,S,142,4,146,0.00001
Gallaecimonas sp. HK-28,2291597,S,102,2,104,0.00001
Anaerolinea thermophila,167964,S,167,3,170,0.00002
[Eubacterium] rectale,39491,S,103012,6194,109206,0.01076
Frankia sp. QA3,710111,S,116,67,183,0.00002
Marinomonas sp. MWYL1,400668,S,161,11,172,0.00002
Streptomyces sp. P3,2135430,S,146,12,158,0.00002
Pedobacter steynii,430522,S,54,8,62,0.00001
Alcanivorax dieselolei,285091,S,275,18,293,0.00003
Maribacter sp. T28,1836467,S,90,3,93,0.00001
Roseomonas sp. FDAARGOS_362,2018065,S,15536,2712,18248,0.0018
Aeromicrobium sp. A1-2,2107713,S,289,34,323,0.00003
Granulibacter bethesdensis,364410,S,450,11,461,0.00005
Helicobacter hepaticus,32025,S,17,13,30,0
Burkholderia pseudomultivorans,1207504,S,60,66,126,0.00001
Helicobacter cetorum,138563,S,15,0,15,0
Methylobacterium sp. DM1,2067957,S,384,220,604,0.00006
Polaribacter sp. SA4-12,1312072,S,135,15,150,0.00001
Tenacibaculum maritimum,107401,S,87,6,93,0.00001
Mycobacteroides immunogenum,83262,S,1455,265,1720,0.00017
Pseudomonas virus MP1412,1981049,S,27,19,46,0
Mycolicibacter terrae,1788,S,1653,380,2033,0.0002
Aeribacillus pallidus,33936,S,51,33,84,0.00001
Providencia sneebia,516075,S,43,1,44,0
Anoxybacillus flavithermus,33934,S,132,150,282,0.00003
Bacillus cohnii,33932,S,53,3,56,0.00001
Salmonella phage 7-11,1054968,S,28,0,28,0
Mycobacterium marinum,1781,S,161,64,225,0.00002
Helicobacter himalayensis,1591088,S,18,0,18,0
Wenzhouxiangella marina,1579979,S,273,6,279,0.00003
Kushneria konosiri,698828,S,130,25,155,0.00002
Acidiphilium multivorum,62140,S,100,239,339,0.00003
Calothrix parasitica,1973486,S,46,1,47,0
Raoultella ornithinolytica,54291,S,8420,11387,19807,0.00195
Lactobacillus coryniformis,1610,S,487,51,538,0.00005
Chlorobaculum parvum,274539,S,57,5,62,0.00001
Chlorobaculum limnaeum,274537,S,87,10,97,0.00001
Staphylococcus stepanovicii,643214,S,75,3,78,0.00001
Streptomyces sp. GSSD-12,2282738,S,149,14,163,0.00002
Dermabacter vaginalis,1630135,S,129,110,239,0.00002
Erwinia phage vB_EamM-Y2,1051676,S,27,0,27,0
Sulfurospirillum sp. UCH001,1581011,S,1428,58,1486,0.00015
Hymenobacter sp. DG25B,1385664,S,50,40,90,0.00001
Blastochloris viridis,1079,S,780,116,896,0.00009
Rhodopseudomonas palustris,1076,S,7189,1585,8774,0.00086
Listeria welshimeri,1643,S,29,2,31,0
Hyphomicrobium nitrativorans,1427356,S,359,16,375,0.00004
Desulfitobacterium dichloroeliminans,233055,S,116,166,282,0.00003
Methanobrevibacter sp. AbM4,224719,S,82,0,82,0.00001
Chlorobium phaeovibrioides,1094,S,23,1,24,0
Streptomyces alboflavus,67267,S,175,15,190,0.00002
Chlorobium phaeobacteroides,1096,S,139,14,153,0.00002
Chlorobaculum tepidum,1097,S,108,22,130,0.00001
Chlorobium limicola,1092,S,112,5,117,0.00001
Burkholderia sp. BDU8,1385592,S,94,19,113,0.00001
Vibrio fluvialis,676,S,280,17,297,0.00003
Burkholderia sp. BDU6,1385591,S,84,17,101,0.00001
Vibrio parahaemolyticus,670,S,167,34,201,0.00002
Shigella phage SHFML-11,1863008,S,10,43,53,0.00001
Vibrio vulnificus,672,S,209,13,222,0.00002
Grimontia hollisae,673,S,132,2,134,0.00001
Celeribacter ethanolicus,1758178,S,699,492,1191,0.00012
Aeromonas sp. ASNIH5,1758179,S,2580,5999,8579,0.00085
Escherichia virus YD2008s,1981026,S,10,3,13,0
Escherichia virus EK99P1,1981027,S,20,7,27,0
Alkalilimnicola ehrlichii,351052,S,285,16,301,0.00003
Escherichia virus K1H,1911010,S,337,173,510,0.00005
Flavisolibacter tropicus,1492898,S,89,18,107,0.00001
Bradyrhizobium sp. SK17,2057741,S,1504,326,1830,0.00018
Bifidobacterium animalis,28025,S,1778,99,1877,0.00018
Sulfuricella denitrificans,649841,S,562,18,580,0.00006
Sphingomonas hengshuiensis,1609977,S,860,18,878,0.00009
Corynebacterium flavescens,28028,S,94,5,99,0.00001
Escherichia virus TLS,245685,S,14,10,24,0
Gordonibacter pamelaeae,471189,S,2391,563,2954,0.00029
Lactobacillus murinus,1622,S,971,20,991,0.0001
Alloactinosynnema sp. L-07,1653480,S,278,43,321,0.00003
Staphylococcus hyicus,1284,S,29,1,30,0
Brachybacterium faecium,43669,S,251,88,339,0.00003
Zhihengliuella sp. ISTPL4,2058657,S,440,882,1322,0.00013
Bacillus cellulosilyticus,1413,S,44,1,45,0
Turneriella parva,29510,S,77,0,77,0.00001
Geoalkalibacter subterraneus,483547,S,467,294,761,0.00008
Blautia hansenii,1322,S,6109,588,6697,0.00066
Streptococcus acidominimus,1326,S,3783,199,3982,0.00039
Sphingorhabdus sp. M41,1806885,S,205,16,221,0.00002
Streptobacillus moniliformis,34105,S,760,47,807,0.00008
Staphylococcus pseudintermedius,283734,S,99,9,108,0.00001
Herbinix luporum,1679721,S,351,44,395,0.00004
Streptococcus anginosus,1328,S,2471,724,3195,0.00031
Fusobacterium varium,856,S,469,53,522,0.00005
Coxiella burnetii,777,S,51,11,62,0.00001
Lactobacillus bombi,1303590,S,65,0,65,0.00001
Halobacterium hubeiense,1407499,S,20,13,33,0
Pseudomonas virus Ab26,1921547,S,22,13,35,0
Deinococcus geothermalis,68909,S,289,28,317,0.00003
Dehalobacterium formicoaceticum,51515,S,1649,133,1782,0.00018
Kosmotoga olearia,651457,S,23,1,24,0
Halomicronema hongdechloris,1209493,S,39,1,40,0
Jeotgalibaca sp. PTS2502,1903686,S,3259,585,3844,0.00038
Paracoccus yeei,147645,S,19680,12349,32029,0.00316
Lacimicrobium alkaliphilum,1526571,S,106,1,107,0.00001
Tenacibaculum jejuense,584609,S,192,9,201,0.00002
Mesorhizobium opportunistum,593909,S,707,320,1027,0.0001
Dokdonia donghaensis,326320,S,14,9,23,0
Persicobacter sp. JZB09,1085624,S,65,1,66,0.00001
Methanosphaera sp. BMS,1789762,S,15,0,15,0
Moorella thermoacetica,1525,S,120,0,120,0.00001
Pediococcus acidilactici,1254,S,319,20,339,0.00003
Pediococcus pentosaceus,1255,S,257,22,279,0.00003
Enterobacter sp. 638,399742,S,694,28,722,0.00007
Ruminiclostridium cellulolyticum,1521,S,148,3,151,0.00001
Streptomyces sp. TN58,234612,S,98,14,112,0.00001
Actinoplanes friuliensis,196914,S,307,94,401,0.00004
Prauserella marina,530584,S,205,13,218,0.00002
Moraxellaceae bacterium HYN0046,2283318,S,194,0,194,0.00002
Rahnella aquatilis,34038,S,687,709,1396,0.00014
Phaeobacter sp. LSS9,681157,S,45,81,126,0.00001
Caulobacter segnis,88688,S,1396,461,1857,0.00018
Desulfatibacillum alkenivorans,259354,S,248,3,251,0.00002
Klebsiella michiganensis,1134687,S,2152,12415,14567,0.00144
Pseudomonas mendocina,300,S,3537,360,3897,0.00038
Staphylococcus pettenkoferi,170573,S,57,4,61,0.00001
Kangiella koreensis,261964,S,56,3,59,0.00001
Pseudomonas putida,303,S,10230,3813,14043,0.00138
Aminobacter sp. MSH1,374606,S,4376,1349,5725,0.00056
Ralstonia solanacearum,305,S,2254,1940,4194,0.00041
Streptomyces sp. Go-475,2072505,S,79,10,89,0.00001
Streptomyces gilvosporeus,553510,S,118,11,129,0.00001
Idiomarinaceae bacterium HL-53,1298881,S,48,3,51,0.00001
Pseudomonas virus EL,1984787,S,12,0,12,0
Actinoalloteichus sp. AHMU CJ021,2072503,S,207,21,228,0.00002
Streptomyces niveus,193462,S,253,22,275,0.00003
Aquaspirillum sp. LM1,1938604,S,8232,684,8916,0.00088
Brevundimonas sp. LM2,1938605,S,2743,200,2943,0.00029
Janthinobacterium sp. LM6,1938606,S,6243,1504,7747,0.00076
Sphingomonas sp. LM7,1938607,S,565,18,583,0.00006
Octadecabacter antarcticus,1217908,S,242,11,253,0.00002
Salinispora arenicola,168697,S,156,27,183,0.00002
Aeromonas virus phiO18P,393598,S,10,0,10,0
Fusobacterium hwasookii,1583098,S,79,88,167,0.00002
Caldithrix abyssi,187145,S,79,0,79,0.00001
Klebsiella virus KLPN1,1981041,S,14,3,17,0
Jeotgalibacillus malaysiensis,1508404,S,143,13,156,0.00002
Achromobacter sp. AONIH1,1758194,S,944,515,1459,0.00014
Serratia sp. SSNIH1,1758196,S,36,146,182,0.00002
Salinispora tropica,168695,S,96,18,114,0.00001
Corynebacterium minutissimum,38301,S,104,9,113,0.00001
Streptomyces pristinaespiralis,38300,S,109,11,120,0.00001
Olsenella sp. oral taxon 807,712411,S,315,12,327,0.00003
Corynebacterium mycetoides,38302,S,141,21,162,0.00002
Serratia proteamaculans,28151,S,510,23,533,0.00005
Escherichia virus Septima11,1987941,S,36,2,38,0
Yersinia kristensenii,28152,S,61,639,700,0.00007
Sinorhizobium americanum,194963,S,923,225,1148,0.00011
Lactobacillus curieae,1138822,S,49,1,50,0
Paenibacillus graminis,189425,S,48,7,55,0.00001
Hungateiclostridium clariflavum,288965,S,98,17,115,0.00001
Algoriphagus sp. M8-2,1727163,S,44,1,45,0
Corynebacterium frankenforstense,1230998,S,167,15,182,0.00002
Flavonifractor plautii,292800,S,3067,46,3113,0.00031
Pedobacter sp. PACM 27299,1727164,S,57,15,72,0.00001
Desulfobulbus sp. ORNL,1986146,S,1069,154,1223,0.00012
Stappia sp. ES.058,1881061,S,446,15,461,0.00005
Ottowia oryzae,2109914,S,64761,4478,69239,0.00682
Melaminivora sp. SC2-9,2109913,S,15541,4325,19866,0.00196
Pseudomonas frederiksbergensis,104087,S,1796,353,2149,0.00021
Friedmanniella luteola,546871,S,516,65,581,0.00006
Paenibacillus sp. BIHB4019,1870819,S,77,3,80,0.00001
Leptospira alstonii,28452,S,18,0,18,0
Aromatoleum aromaticum,551760,S,2124,100,2224,0.00022
Tenacibaculum todarodis,1850252,S,203,29,232,0.00002
Marivivens sp. JLT3646,1920883,S,137,88,225,0.00002
Marinobacter salarius,1420917,S,227,12,239,0.00002
Streptomyces sp. RTd22,1841249,S,162,12,174,0.00002
Enterobacteria phage K1F,344021,S,41,29,70,0.00001
Brucella sp. 09RB8471,1149952,S,62,46,108,0.00001
Escherichia virus K1E,344022,S,35,6,41,0
Rhodospirillaceae bacterium SCSIO 08040,2220096,S,399,49,448,0.00004
Wigglesworthia glossinidia,51229,S,15,0,15,0
Actinotignum sp. 313,2171980,S,119,5,124,0.00001
Streptomyces sp. 4F,1751294,S,90,14,104,0.00001
Bordetella hinzii,103855,S,1085,228,1313,0.00013
Methylomicrobium alcaliphilum,271065,S,124,2,126,0.00001
Alistipes finegoldii,214856,S,1408,152,1560,0.00015
Burkholderia pyrrocinia,60550,S,339,191,530,0.00005
Phaeobacter piscinae,1580596,S,663,568,1231,0.00012
Burkholderia vietnamiensis,60552,S,167,626,793,0.00008
Corynebacterium cystitidis,35757,S,35,0,35,0
Gordonia phage Lucky10,1821557,S,34,0,34,0
Flavobacterium johnsoniae,986,S,694,661,1355,0.00013
Kutzneria albida,43357,S,324,47,371,0.00004
Idiomarina sp. OT37-5b,2100422,S,90,8,98,0.00001
Shewanella marisflavi,260364,S,42,1,43,0
Gordonia phage GAL1,1647469,S,71,0,71,0.00001
Enterobacter cloacae complex sp.,2027919,S,1527,730,2257,0.00022
Geobacter uraniireducens,351604,S,161,3,164,0.00002
Mycobacterium virus JAMaL,1983107,S,19,10,29,0
Pseudomonas libanensis,75588,S,1245,909,2154,0.00021
Mycobacterium sp. JLS,164757,S,247,220,467,0.00005
Cytophaga hutchinsonii,985,S,97,2,99,0.00001
Methylomonas denitrificans,1538553,S,253,7,260,0.00003
Croceicoccus naphthovorans,1348774,S,735,957,1692,0.00017
Brachybacterium ginsengisoli,1331682,S,220,70,290,0.00003
Streptomyces sp. 769,1262452,S,55,11,66,0.00001
Arachidicoccus sp. KIS59-12,2341117,S,89,15,104,0.00001
Marinifilaceae bacterium SPP2,1717717,S,116,0,116,0.00001
Streptomyces sp. PAMC 26508,1265601,S,14,12,26,0
Dialister sp. Marseille-P5638,2161821,S,14408,770,15178,0.0015
Micromonospora echinaurantiaca,47857,S,146,56,202,0.00002
Desulfomonile tiedjei,2358,S,135,0,135,0.00001
Acinetobacter wuhouensis,1879050,S,5982,452,6434,0.00063
Flexistipes sinusarabici,2352,S,20,0,20,0
Haliscomenobacter hydrossis,2350,S,263,0,263,0.00003
Pseudomonas phage PaMx42,1175662,S,95,0,95,0.00001
Bacillus sp. OxB-1,98228,S,50,4,54,0.00001
Serratia sp. ATCC 39006,104623,S,107,1,108,0.00001
Corynebacterium sp. 2184,2079535,S,124,8,132,0.00001
Actinomyces sp. Z16,2079536,S,268,16,284,0.00003
Dickeya sp. NCPPB 3274,568766,S,36,2,38,0
Pantoea vagans,470934,S,1067,145,1212,0.00012
Kitasatospora aureofaciens,1894,S,130,43,173,0.00002
Shewanella sp. WE21,2029986,S,39,4,43,0
Streptomyces antibioticus,1890,S,105,14,119,0.00001
Halorhabdus tiamatea,430914,S,11,4,15,0
Streptomyces anulatus,1892,S,51,17,68,0.00001
Pseudomonas palleroniana,191390,S,1687,137,1824,0.00018
Hoeflea phototrophica,244596,S,425,38,463,0.00005
Shewanella sediminis,271097,S,48,1,49,0
Rubrobacter radiotolerans,42256,S,71,11,82,0.00001
Novosphingobium resinovorum,158500,S,2402,615,3017,0.0003
Ureaplasma urealyticum,2130,S,10,6,16,0
Pontimonas salivibrio,1159327,S,53,1,54,0.00001
Stenotrophomonas acidaminiphila,128780,S,25970,10877,36847,0.00363
Lactococcus phage P680,1262537,S,215,99,314,0.00003
Methanobacterium congolense,118062,S,48,8,56,0.00001
Streptomyces sp. TLI_053,1855352,S,252,50,302,0.00003
Spiroplasma clarkii,2139,S,17,2,19,0
Pseudoalteromonas rubra,43658,S,63,2,65,0.00001
Komagataeibacter europaeus,33995,S,146,25,171,0.00002
Cronobacter universalis,535744,S,122,33,155,0.00002
Herminiimonas arsenicoxydans,204773,S,443,152,595,0.00006
Pseudoalteromonas luteoviolacea,43657,S,29,1,30,0
Tateyamaria omphalii,299262,S,475,12,487,0.00005
Erwinia pyrifoliae,79967,S,24,66,90,0.00001
Brevundimonas vesicularis,41276,S,6567,3702,10269,0.00101
Fictibacillus phosphorivorans,1221500,S,42,3,45,0
Methanoregula boonei,358766,S,19,1,20,0
Methanosaeta harundinacea,301375,S,32,1,33,0
Aerococcaceae bacterium ZY16052,2036206,S,169,15,184,0.00002
Erwinia billingiae,182337,S,335,21,356,0.00004
Chondrocystis sp. NIES-4102,2005460,S,38,5,43,0
Halomonas aestuarii,1897729,S,274,13,287,0.00003
Rhizobium sp. Y9,1914541,S,679,2046,2725,0.00027
Nitrosococcus halophilus,133539,S,70,1,71,0.00001
Pseudomonas poae,200451,S,1150,330,1480,0.00015
Acinetobacter sp. LoGeW2-3,1808001,S,918,33,951,0.00009
Candidatus Riesia pediculicola,401619,S,12,2,14,0
Sulfurovum sp. NBC37-1,387093,S,23,8,31,0
Nitratiruptor sp. SB155-2,387092,S,10,0,10,0
Bordetella genomosp. 13,463040,S,754,231,985,0.0001
Gordonia virus Woes,1982751,S,12,0,12,0
Ochrobactrum sp. A44,271865,S,1237,87,1324,0.00013
Halobacterium sp. DL1,751944,S,16,11,27,0
Microbacterium sp. CGR1,1696072,S,97,518,615,0.00006
Mycobacterium intracellulare,1767,S,220,511,731,0.00007
Xanthomonas perforans,442694,S,158,920,1078,0.00011
Streptosporangium roseum,2001,S,276,56,332,0.00003
Thermobispora bispora,2006,S,244,19,263,0.00003
Aeromonas sp. ASNIH4,1636609,S,841,745,1586,0.00016
Shewanella halifaxensis,271098,S,23,0,23,0
Saccharomonospora viridis,1852,S,135,15,150,0.00001
Rhizobium sp. S41,1869170,S,2076,8551,10627,0.00105
Idiomarina piscisalsi,1096243,S,23,7,30,0
Waddlia chondrophila,71667,S,17,6,23,0
Photorhabdus asymbiotica,291112,S,39,7,46,0
Gramella forsetii,411153,S,95,17,112,0.00001
Aeromicrobium marinum,219314,S,369,63,432,0.00004
Stenotrophomonas rhizophila,216778,S,5942,1201,7143,0.0007
Acinetobacter pittii,48296,S,4944,552,5496,0.00054
Gordonia phage GTE6,1647474,S,226,0,226,0.00002
Gordonia phage GTE8,1647475,S,74,0,74,0.00001
Deinococcus puniceus,1182568,S,89,2,91,0.00001
Candidatus Sulcia muelleri,336810,S,25,10,35,0
Arthrobacter sp. Rue61a,1118963,S,20,124,144,0.00001
Chelatococcus sp. CO-6,1702325,S,981,481,1462,0.00014
Rhodopirellula baltica,265606,S,54,1,55,0.00001
Pseudodesulfovibrio indicus,1716143,S,280,14,294,0.00003
Rufibacter tibetensis,512763,S,40,7,47,0
Pantoea sp. PSNIH2,1484157,S,88,560,648,0.00006
Pantoea sp. PSNIH1,1484158,S,1087,322,1409,0.00014
Treponema brennaborense,81028,S,77,3,80,0.00001
Anaerococcus prevotii,33034,S,69,6,75,0.00001
Azoarcus sp. SY39,2067960,S,954,79,1033,0.0001
Salmonella bongori,54736,S,293,4,297,0.00003
Sulfurimonas autotrophica,202747,S,41,0,41,0
Finegoldia magna,1260,S,365,48,413,0.00004
Rhodococcus opacus,37919,S,693,71,764,0.00008
Myroides profundi,480520,S,41,3,44,0
Actinobacillus equuli,718,S,32,9,41,0
Actinobacillus suis,716,S,31,12,43,0
Actinobacillus pleuropneumoniae,715,S,87,35,122,0.00001
Aggregatibacter actinomycetemcomitans,714,S,185,18,203,0.00002
Acinetobacter oleivorans,1148157,S,368,44,412,0.00004
Lactobacillus koreensis,637971,S,77,0,77,0.00001
Klebsiella phage vB_KpnM_KB57,1719140,S,282,0,282,0.00003
Lysobacter maris,1605891,S,5108,876,5984,0.00059
Rhodomicrobium vannielii,1069,S,349,9,358,0.00004
Acidaminococcus intestini,187327,S,1511,287,1798,0.00018
[Clostridium] bolteae,208479,S,7537,1423,8960,0.00088
Defluviimonas alba,1335048,S,3802,1378,5180,0.00051
Rhodobacter capsulatus,1061,S,2095,176,2271,0.00022
Rhodobacter sphaeroides,1063,S,8839,1280,10119,0.001
[Eubacterium] cellulosolvens,29322,S,865,3,868,0.00009
Limnochorda pilosa,1555112,S,142,0,142,0.00001
Bordetella sp. N,1746199,S,838,51,889,0.00009
Trueperella pyogenes,1661,S,308,31,339,0.00003
Methylocystis bryophila,655015,S,367,36,403,0.00004
Oceanobacillus kimchii,746691,S,33,2,35,0
Rhodospirillum rubrum,1085,S,387,6,393,0.00004
Pararhodospirillum photometricum,1084,S,298,26,324,0.00003
Nitrospira defluvii,330214,S,604,6,610,0.00006
Melaminivora sp. SC2-7,2116657,S,14085,2753,16838,0.00166
Chryseobacterium camelliae,1265445,S,491,182,673,0.00007
Escherichia phage slur05,1720498,S,36,11,47,0
Streptomyces cavourensis,67258,S,20,22,42,0
Escherichia phage HK639,906669,S,13,1,14,0
Gillisia sp. Hel1_33_143,1336796,S,83,14,97,0.00001
Sulfurihydrogenibium azorense,309806,S,36,4,40,0
Formosa sp. Hel1_33_131,1336794,S,87,3,90,0.00001
Formosa sp. Hel3_A1_48,1336795,S,49,8,57,0.00001
Paracoccus phage vB_PmaS_IMEP1,1561065,S,25,0,25,0
Bacillus butanolivorans,421767,S,28,1,29,0
Pseudomonas fuscovaginae,50340,S,217,109,326,0.00003
Curtobacterium sp. BH-2-1-1,1905847,S,304,135,439,0.00004
Lysinibacillus fusiformis,28031,S,38,30,68,0.00001
Methanobrevibacter sp. YE315,1609968,S,84,0,84,0.00001
Streptococcus mitis,28037,S,1378,195,1573,0.00016
Cellulophaga baltica,76594,S,160,19,179,0.00002
Staphylococcus lugdunensis,28035,S,69,2,71,0.00001
Candidatus Baumannia cicadellinicola,186490,S,33,0,33,0
Halomonas sp. KO116,1504981,S,88,42,130,0.00001
Confluentimicrobium sp. EMB200-NS6,1609966,S,1218,1152,2370,0.00023
Polymorphum gilvum,991904,S,1603,213,1816,0.00018
Salmonella virus f18SE,1981032,S,13,6,19,0
Leclercia adecarboxylata,83655,S,1729,1230,2959,0.00029
Bacillus pumilus,1408,S,48,13,61,0.00001
Escherichia virus wV8,1965385,S,22,15,37,0
Micromonospora coriariae,285665,S,119,30,149,0.00001
Paenibacillus lautus,1401,S,25,12,37,0
Paenibacillus polymyxa,1406,S,138,512,650,0.00006
Bacillus mycoides,1405,S,41,3,44,0
Bacillus megaterium,1404,S,100,53,153,0.00002
Tessaracoccus flavescens,399497,S,16629,4246,20875,0.00206
Chromobacterium sp. IIBBL 112-1,2202141,S,55,408,463,0.00005
Legionella hackeliae,449,S,45,18,63,0.00001
Streptococcus intermedius,1338,S,917,299,1216,0.00012
Pelodictyon phaeoclathratiforme,34090,S,21,0,21,0
Streptococcus equinus,1335,S,1518,937,2455,0.00024
Halomonas sp. hl-4,1761789,S,27,192,219,0.00002
Streptomyces lydicus,47763,S,224,41,265,0.00003
Streptococcus equi,1336,S,2297,62,2359,0.00023
Legionella pneumophila,446,S,188,132,320,0.00003
Fermentimonas caenicola,1562970,S,198,16,214,0.00002
Granulosicoccus antarcticus,437505,S,106,0,106,0.00001
Megasphaera stantonii,2144175,S,499,39,538,0.00005
Synechococcus sp. SynAce01,1916956,S,70,10,80,0.00001
Weissella koreensis,165096,S,41,5,46,0
Cytophagales bacterium TFI 002,1945892,S,59,8,67,0.00001
Salmonella phage FSL SP-058,1173761,S,58,19,77,0.00001
Rhodovulum sp. MB263,308754,S,678,259,937,0.00009
Pseudomonas saudiphocaensis,1499686,S,520,17,537,0.00005
Enterococcus phage EFDG1,1597976,S,13,0,13,0
Mycobacterium marseillense,701042,S,355,42,397,0.00004
Corynebacterium sphenisci,191493,S,295,34,329,0.00003
Pseudomonas guangdongensis,1245526,S,900,58,958,0.00009
Polaromonas sp. JS666,296591,S,6589,332,6921,0.00068
Acholeplasma brassicae,61635,S,274,35,309,0.00003
Pseudothermotoga thermarum,119394,S,14,7,21,0
Myxococcus macrosporus,35,S,36,165,201,0.00002
Myxococcus xanthus,34,S,119,36,155,0.00002
Bradyrhizobium sp. BTAi1,288000,S,887,129,1016,0.0001
Campylobacter volucris,1031542,S,12,0,12,0
Altererythrobacter namhicola,645517,S,378,27,405,0.00004
Clostridium kluyveri,1534,S,506,2,508,0.00005
Aeromonas salmonicida,645,S,2304,460,2764,0.00027
Aeromonas hydrophila,644,S,5711,3216,8927,0.00088
Oenococcus oeni,1247,S,101,8,109,0.00001
Leuconostoc lactis,1246,S,569,318,887,0.00009
Pseudomonas antarctica,219572,S,2568,343,2911,0.00029
Aeromonas caviae,648,S,2566,3202,5768,0.00057
Paenibacillus ihbetae,1870820,S,82,5,87,0.00001
Thermodesulfatator indicus,171695,S,17,0,17,0
Clostridium ljungdahlii,1538,S,11,2,13,0
Nonlabens sp. MB-3u-79,2058134,S,70,14,84,0.00001
Olleya sp. Bg11-27,2058135,S,103,8,111,0.00001
Planococcus sp. MB-3u-03,2058136,S,32,9,41,0
Polaribacter sp. ALD11,2058137,S,89,13,102,0.00001
Xanthomonas campestris,339,S,3999,5130,9129,0.0009
Streptomyces violaceoruber,1935,S,95,22,117,0.00001
Erwinia phage vB_EamP-S6,1051675,S,18,0,18,0
Burkholderia glumae,337,S,421,168,589,0.00006
Pseudomonas pseudoalcaligenes,330,S,1636,3420,5056,0.0005
Streptomyces sp. CNQ-509,444103,S,77,9,86,0.00001
Lactobacillus heilongjiangensis,1074467,S,104,1,105,0.00001
Paenibacillus sp. IHBB 10380,1566358,S,28,2,30,0
Rhizobacter gummiphilus,946333,S,2615,428,3043,0.0003
Escherichia virus RB43,115991,S,12,13,25,0
Synechococcus sp. WH 8020,32052,S,78,28,106,0.00001
Clostridium cochlearium,1494,S,122,3,125,0.00001
Legionella fallonii,96230,S,59,5,64,0.00001
Staphylococcus simiae,308354,S,35,1,36,0
Treponema putidum,221027,S,17,8,25,0
Salmonella virus HB2014,1965377,S,11,8,19,0
Psychrobacter arcticus,334543,S,15670,588,16258,0.0016
Rhodococcus qingshengii,334542,S,474,1355,1829,0.00018
Paenibacillus riograndensis,483937,S,65,7,72,0.00001
Citrobacter phage SH3,1805466,S,11,7,18,0
Nostoc sp. 'Peltigera membranacea cyanobiont' N6,1261031,S,14,7,21,0
Niabella soli,446683,S,66,18,84,0.00001
Corynebacterium kutscheri,35755,S,12,0,12,0
Shewanella algae,38313,S,125,17,142,0.00001
Rhodococcus coprophilus,38310,S,282,32,314,0.00003
Lactococcus phage asccphi28,503388,S,14,0,14,0
Cronobacter sakazakii,28141,S,470,433,903,0.00009
Rummeliibacillus stabekisii,241244,S,42,5,47,0
Campylobacter cuniculorum,374106,S,23,0,23,0
Riemerella anatipestifer,34085,S,1505,730,2235,0.00022
Pseudomonas lurida,244566,S,480,779,1259,0.00012
Wolinella succinogenes,844,S,39,1,40,0
Muricauda ruestringensis,111501,S,99,2,101,0.00001
Klebsiella variicola,244366,S,2953,10667,13620,0.00134
Yoonia vestfoldensis,245188,S,771,282,1053,0.0001
Amycolatopsis sp. BJA-103,1911175,S,114,33,147,0.00001
Rhodoferax antarcticus,81479,S,6134,307,6441,0.00063
Advenella kashmirensis,310575,S,406,43,449,0.00004
Salmonella phage FSL SP-076,1173762,S,58,27,85,0.00001
Natrialba magadii,13769,S,53,3,56,0.00001
Pseudanabaena sp. PCC 7367,82654,S,47,0,47,0
Acidiferrobacter sp. SPIII_3,1281578,S,146,1,147,0.00001
Pseudomonas virus PaMx28,1982357,S,33,5,38,0
Helicobacter typhlonius,76936,S,15,11,26,0
Sphingomonas koreensis,93064,S,2951,833,3784,0.00037
Persephonella marina,309805,S,17,0,17,0
Frateuria aurantia,81475,S,345,46,391,0.00004
Frondihabitans sp. 762G35,1446794,S,453,78,531,0.00005
Ralstonia pseudosolanacearum,1310165,S,23,2408,2431,0.00024
Escherichia virus AYO145A,1965378,S,24,22,46,0
Flavobacterium psychrophilum,96345,S,2491,1353,3844,0.00038
Cupriavidus oxalaticus,96344,S,734,133,867,0.00009
Escherichia virus JH2,1965379,S,11,10,21,0
Klebsiella virus F19,1920780,S,29,5,34,0
Klebsiella virus K244,1920781,S,14,8,22,0
Streptococcus marmotae,1825069,S,1150,35,1185,0.00012
Endomicrobium proavitum,1408281,S,20,192,212,0.00002
Providencia sp. WCHPr000369,2027290,S,95,42,137,0.00001
Choristoneura occidentalis granulovirus,364745,S,29,0,29,0
Janibacter indicus,857417,S,1495,380,1875,0.00018
Pantoea sp. At-9b,592316,S,216,4,220,0.00002
Rhodococcus sp. WB1,1033922,S,18,73,91,0.00001
Paraburkholderia graminis,60548,S,85,573,658,0.00006
Citrobacter virus Moogle,1985304,S,26,10,36,0
Roseovarius sp. TM1035,391613,S,174,277,451,0.00004
Xenorhabdus doucetiae,351671,S,54,4,58,0.00001
Bacteroidetes bacterium Omega,1457365,S,87,0,87,0.00001
Corynebacterium ureicelerivorans,401472,S,236,27,263,0.00003
Salmonella virus SS3e,2005701,S,17,10,27,0
Salmonella virus SETP3,2005700,S,10,6,16,0
Microbulbifer agarilyticus,260552,S,134,2,136,0.00001
Xenorhabdus hominickii,351679,S,49,4,53,0.00001
Enterococcus wangshanyuanii,2005703,S,382,5,387,0.00004
Oceanisphaera profunda,1416627,S,106,3,109,0.00001
Lachnoclostridium sp. YL32,1834196,S,3336,505,3841,0.00038
Flavobacterium sp. HYN0059,2175091,S,72,1,73,0.00001
Yangia pacifica,311180,S,925,194,1119,0.00011
Enterobacter sp. HK169,1868135,S,786,611,1397,0.00014
Alteromonas mediterranea,314275,S,153,226,379,0.00004
Escherichia virus K1-5,187764,S,49,5,54,0.00001
Desulfotalea psychrophila,84980,S,133,37,170,0.00002
Pseudoalteromonas phenolica,161398,S,40,2,42,0
Acinetobacter sp. WCHAc010034,1879049,S,7924,600,8524,0.00084
Exiguobacterium sp. MH3,1399115,S,103,24,127,0.00001
Psychroflexus torquis,57029,S,72,0,72,0.00001
Haloarcula marismortui,2238,S,21,14,35,0
Rhodococcus biphenylivorans,1500843,S,36,199,235,0.00002
Streptomyces sp. Sge12,1972846,S,24,10,34,0
Halalkalicoccus jeotgali,413810,S,15,0,15,0
Paraburkholderia sp. SOS3,1926494,S,376,27,403,0.00004
Pseudoalteromonas agarivorans,176102,S,38,60,98,0.00001
Variibacter gotjawalensis,1333996,S,501,21,522,0.00005
Streptomyces ambofaciens,1889,S,91,14,105,0.00001
Streptomyces albus,1888,S,152,52,204,0.00002
Deinococcus swuensis,1182571,S,170,5,175,0.00002
Streptomyces actuosus,1885,S,103,14,117,0.00001
Streptococcus parasanguinis,1318,S,6760,237,6997,0.00069
Burkholderia mallei,13373,S,11,58,69,0.00001
Geminocystis sp. NIES-3708,1615909,S,46,4,50,0
Micromonospora viridifaciens,1881,S,144,48,192,0.00002
Seonamhaeicola sp. S2-3,1936081,S,224,20,244,0.00002
Terribacillus aidingensis,586416,S,36,1,37,0
Salmonella virus Jersey,2005696,S,92,2,94,0.00001
Sphingopyxis alaskensis,117207,S,2969,281,3250,0.00032
Mycoplasma flocculare,2128,S,32,36,68,0.00001
Ehrlichia canis,944,S,10,8,18,0
Burkholderia ubonensis,101571,S,403,281,684,0.00007
Shigella phage pSf-1,1315956,S,52,0,52,0.00001
Celeribacter manganoxidans,1411902,S,814,237,1051,0.0001
Paraglaciecola psychrophila,326544,S,54,2,56,0.00001
Thermotoga profunda,1508420,S,30,7,37,0
Sphingomonas sp. MM-1,745310,S,1209,794,2003,0.0002
Psychrobacter sp. P2G3,1699622,S,4414,5282,9696,0.00096
Escherichia virus HY02,1985308,S,20,17,37,0
Cellulophaga algicola,59600,S,89,22,111,0.00001
Paraburkholderia caledonica,134536,S,312,64,376,0.00004
Paraburkholderia fungorum,134537,S,472,131,603,0.00006
Paraburkholderia xenovorans,36873,S,1078,468,1546,0.00015
Sphingobium sp. TKS,1315974,S,1167,868,2035,0.0002
Oscillatoria nigro-viridis,482564,S,154,12,166,0.00002
Stenotrophomonas sp. ZAC14D2_NAIMI4_7,2072405,S,568,583,1151,0.00011
Streptomyces leeuwenhoekii,1437453,S,63,14,77,0.00001
Propionibacterium sp. oral taxon 193,671223,S,59,23,82,0.00001
Bordetella genomosp. 9,1416803,S,759,96,855,0.00008
Marinomonas posidonica,936476,S,99,10,109,0.00001
Thermus brockianus,56956,S,21,3,24,0
Thermus oshimai,56957,S,31,9,40,0
Cellvibrio sp. PSBB023,1945512,S,203,9,212,0.00002
Parvularcula bermudensis,208216,S,91,0,91,0.00001
Burkholderia sp. MSMB0856,1637869,S,74,43,117,0.00001
Magnetospirillum magneticum,84159,S,300,87,387,0.00004
Marinobacter psychrophilus,330734,S,81,40,121,0.00001
Streptomyces scabiei,1930,S,144,11,155,0.00002
Parabacteroides sp. CT06,2025876,S,1267,1632,2899,0.00029
Nocardiopsis dassonvillei,2014,S,238,46,284,0.00003
Burkholderia sp. LA-2-3-30-S1-D2,1637862,S,69,34,103,0.00001
Geminocystis herdmanii,669359,S,221,18,239,0.00002
Hydromonas sp. F02,2268024,S,770,20,790,0.00008
Pseudomonas sp. NC02,2067572,S,1671,284,1955,0.00019
Streptomyces sp. CB09001,2083284,S,78,14,92,0.00001
Pseudovibrio sp. FO-BEG1,911045,S,153,4,157,0.00002
Pseudomonas protegens,380021,S,1914,244,2158,0.00021
Brevefilum fermentans,1986204,S,309,17,326,0.00003
Treponema denticola,158,S,67,72,139,0.00001
Acidithiobacillus ferrivorans,160808,S,511,14,525,0.00005
Rufibacter sp. DG15C,1379909,S,56,8,64,0.00001
Rhodoferax koreense,1842727,S,8388,1632,10020,0.00099
Ochrobactrum pituitosum,571256,S,317,212,529,0.00005
Sulfuricaulis limicola,1620215,S,331,5,336,0.00003
Streptococcus pasteurianus,197614,S,1556,1502,3058,0.0003
Planococcus rifietoensis,200991,S,24,8,32,0
Actinobacteria bacterium IMCC26256,1650658,S,43,0,43,0
Helicobacter sp. MIT 01-6242,222136,S,17,0,17,0
Tannerella forsythia,28112,S,101,7,108,0.00001
Pseudomonas mosselii,78327,S,159,270,429,0.00004
Malacobacter halophilus,197482,S,352,77,429,0.00004
Pseudomonas sp. WCS374,1495331,S,119,2430,2549,0.00025
Afipia sp. GAS231,1882747,S,603,640,1243,0.00012
Escherichia phage ECBP5,1498172,S,13,0,13,0
Ereboglobus luteus,1796921,S,198,5,203,0.00002
Burkholderia sp. MSMB1588,1636423,S,20,104,124,0.00001
Desulfurella acetivorans,33002,S,10,0,10,0
Salmonella phage 64795_sal3,1813769,S,66,7,73,0.00001
Clostridium sp. SY8519,1042156,S,2294,40,2334,0.00023
Opitutus sp. GAS368,1882749,S,515,70,585,0.00006
Mycobacterium dioxanotrophicus,482462,S,2128,275,2403,0.00024
Methanocella arvoryzae,1175445,S,31,0,31,0
Mycolicibacterium litorale,758802,S,1158,77,1235,0.00012
Marichromatium purpuratum,37487,S,373,67,440,0.00004
Blochmannia endosymbiont of Polyrhachis (Hedomyrma) turneri,1505596,S,12,12,24,0
Borrelia coriaceae,144,S,12,37,49,0
Plesiomonas shigelloides,703,S,325,12,337,0.00003
Spirosoma rigui,564064,S,71,6,77,0.00001
Pseudomonas sp. TCU-HL1,1856685,S,801,24,825,0.00008
Synechococcus sp. PCC 7502,1173263,S,11,0,11,0
Gordonia phage GMA7,1647286,S,13,25,38,0
Gordonia phage GMA6,1647285,S,17,1,18,0
Bacillus infantis,324767,S,139,5,144,0.00001
Enterobacter sp. Crenshaw,1977566,S,760,613,1373,0.00014
Rhizobium etli,29449,S,1480,2456,3936,0.00039
Pseudomonas sihuiensis,1274359,S,545,313,858,0.00008
Thermus scotoductus,37636,S,51,10,61,0.00001
Pseudomonas tolaasii,29442,S,2194,280,2474,0.00024
Paucimonas lemoignei,29443,S,387,58,445,0.00004
Cycloclasticus zancles,1329899,S,13,7,20,0
Pantoea alhagi,1891675,S,183,6,189,0.00002
Xanthomonas albilineans,29447,S,1552,83,1635,0.00016
Streptomyces rubrolavendulae,285473,S,131,20,151,0.00001
Isoptericola dokdonensis,372663,S,424,121,545,0.00005
Desulfuromonas sp. DDH964,1823759,S,280,34,314,0.00003
Lactococcus phage D4410,1862958,S,11,22,33,0
Lactococcus phage D4412,1862959,S,39,32,71,0.00001
Wenyingzhuangia fucanilytica,1790137,S,180,14,194,0.00002
Halomonas sp. GFAJ-1,1118153,S,119,5,124,0.00001
Proteus mirabilis,584,S,294,606,900,0.00009
Proteus vulgaris,585,S,90,3,93,0.00001
Morganella morganii,582,S,1515,108,1623,0.00016
Pseudoalteromonas donghaensis,621376,S,32,1,33,0
Candidatus Azobacteroides pseudotrichonymphae,511435,S,80,0,80,0.00001
Pseudomonas taetrolens,47884,S,7063,380,7443,0.00073
Pseudomonas oryzihabitans,47885,S,532,14,546,0.00005
Bifidobacterium pseudocatenulatum,28026,S,18056,2280,20336,0.002
Pseudomonas fulva,47880,S,921,263,1184,0.00012
Providencia stuartii,588,S,135,28,163,0.00002
Pseudomonas synxantha,47883,S,3565,1917,5482,0.00054
Corynebacterium simulans,146827,S,106,33,139,0.00001
Halorhabdus utahensis,146826,S,18,1,19,0
Diaphorobacter polyhydroxybutyrativorans,1546149,S,5549,22367,27916,0.00275
Planococcus plakortidis,1038856,S,54,11,65,0.00001
Cupriavidus basilensis,68895,S,1420,140,1560,0.00015
Vibrio tasmaniensis,212663,S,43,10,53,0.00001
Streptomyces sp. CLI2509,1984801,S,10,10,20,0
Pseudomonas psychrophila,122355,S,16368,1126,17494,0.00172
Zunongwangia profunda,398743,S,115,62,177,0.00002
Synechococcus sp. CC9311,64471,S,21,9,30,0
Listeria ivanovii,1638,S,103,4,107,0.00001
Listeria monocytogenes,1639,S,1897,406,2303,0.00023
Mycobacterium sp. KMS,189918,S,115,2766,2881,0.00028
Luteibacter rhizovicinus,242606,S,592,46,638,0.00006
Ichthyobacterium seriolicida,242600,S,39,0,39,0
Bacteroides zoogleoformans,28119,S,148,26,174,0.00002
Lactobacillus crustorum,392416,S,135,9,144,0.00001
Streptococcus parauberis,1348,S,7472,1165,8637,0.00085
Streptococcus uberis,1349,S,1556,49,1605,0.00016
Agromyces flavus,589382,S,731,152,883,0.00009
Thauera humireducens,1134435,S,3611,513,4124,0.00041
Legionella longbeachae,450,S,34,12,46,0
Tatlockia micdadei,451,S,40,0,40,0
Legionella spiritensis,452,S,54,2,56,0.00001
Streptococcus ferus,1345,S,8046,136,8182,0.00081
Sulfurospirillum multivorans,66821,S,139,75,214,0.00002
Pseudomonas versuta,1788301,S,80406,6441,86847,0.00856
Orrella dioscoreae,1851544,S,924,155,1079,0.00011
Syntrophothermus lipocalidus,86170,S,28,0,28,0
Streptomyces sp. SM18,1736046,S,121,15,136,0.00001
Francisella halioticida,549298,S,10,0,10,0
Flavobacterium sp. HYN0048,2162713,S,113,4,117,0.00001
Maribacter cobaltidurans,1178778,S,41,4,45,0
Thauera sp. K11,2005884,S,3819,680,4499,0.00044
Streptococcus pseudopneumoniae,257758,S,715,183,898,0.00009
Weissella ceti,759620,S,16,0,16,0
Paenibacillus mucilaginosus,61624,S,187,3,190,0.00002
Niveispirillum cyanobacteriorum,1612173,S,739,78,817,0.00008
Aeromonas veronii,654,S,4650,530,5180,0.00051
Clostridium pasteurianum,1501,S,308,5,313,0.00003
Aeromonas schubertii,652,S,310,11,321,0.00003
Clostridium septicum,1504,S,168,2,170,0.00002
Aeromonas media,651,S,8279,2462,10741,0.00106
Eggerthella sp. YY7918,502558,S,408,40,448,0.00004
Enterobacteria phage phi92,948870,S,160,0,160,0.00002
Clostridium sporogenes,1509,S,14257,7092,21349,0.0021
Mycobacterium phage Jolie2,1458831,S,51,3,54,0.00001
beta proteobacterium CB,543913,S,62,30,92,0.00001
Odoribacter splanchnicus,28118,S,1916,98,2014,0.0002
Citrobacter virus Merlin,1985341,S,79,5,84,0.00001
Citrobacter virus Moon,1985342,S,307,27,334,0.00003
Dehalococcoides mccartyi,61435,S,1268,32,1300,0.00013
Rhodococcus sp. 008,1723645,S,497,1230,1727,0.00017
Rhizorhabdus dicambivorans,1850238,S,1251,572,1823,0.00018
Mycoplasma putrefaciens,2123,S,11,11,22,0
Negativicoccus massiliensis,1702287,S,199,8,207,0.00002
Pseudomonas stutzeri,316,S,5231,910,6141,0.00061
Aerococcus christensenii,87541,S,141,8,149,0.00001
Streptomyces sp. ICC1,2099583,S,349,6780,7129,0.0007
Fuerstia marisgermanicae,1891926,S,61,0,61,0.00001
Enterobacteria phage vB_EcoP_ACG-C91,1141139,S,11,0,11,0
Streptomyces sp. Tue 6075,1661694,S,43,14,57,0.00001
Kangiella profundi,1561924,S,88,7,95,0.00001
Vibrio nigripulchritudo,28173,S,47,0,47,0
Pseudonocardia sp. HH130629-09,1641402,S,189,228,417,0.00004
Bartonella henselae,38323,S,11,8,19,0
Candidatus Pelagibacter sp. HIMB1321,1388755,S,17,2,19,0
Xanthomonas phaseoli,1985254,S,848,274,1122,0.00011
Haloferax gibbonsii,35746,S,10,6,16,0
Cupriavidus necator,106590,S,1734,429,2163,0.00021
Deinococcus proteolyticus,55148,S,72,4,76,0.00001
Ensifer adhaerens,106592,S,5527,981,6508,0.00064
Rhodococcus sp. H-CA8f,1727214,S,112,322,434,0.00004
Staphylococcus nepalensis,214473,S,45,1,46,0
Acidovorax sp. JS42,232721,S,25596,118316,143912,0.01418
Nitrospira japonica,1325564,S,72,0,72,0.00001
Oceanobacillus sp. 160,2052660,S,42,2,44,0
Streptomyces violaceusniger,68280,S,77,11,88,0.00001
Saccharophagus degradans,86304,S,67,1,68,0.00001
Paraoerskovia marina,545619,S,301,51,352,0.00003
Candidatus Sodalis pierantonius,1486991,S,37,31,68,0.00001
Olleya aquimaris,639310,S,148,36,184,0.00002
Thermanaerovibrio acidaminovorans,81462,S,50,22,72,0.00001
Hoyosella subflava,639313,S,140,2,142,0.00001
Nonlabens sp. Hel1_33_55,1336802,S,34,11,45,0
Lactobacillus helsingborgensis,1218494,S,25,3,28,0
Caulobacter sp. K31,366602,S,1509,224,1733,0.00017
Oblitimonas alkaliphila,1697053,S,456,16,472,0.00005
Lactobacillus kullabergensis,1218493,S,17,0,17,0
Polaribacter sp. Hel1_33_78,1336804,S,98,9,107,0.00001
Fischerella sp. NIES-4106,2005456,S,20,1,21,0
Actinomyces oris,544580,S,928,193,1121,0.00011
Gramella sp. MAR_2010_147,1250205,S,66,9,75,0.00001
Lactococcus virus Sl4,287412,S,149,56,205,0.00002
Pseudomonas sp. B10,118613,S,575,262,837,0.00008
Pseudarcicella sp. HME7025,2183547,S,75,15,90,0.00001
Microbacterium foliorum,104336,S,1974,422,2396,0.00024
Sphingobium herbicidovorans,76947,S,548,254,802,0.00008
Yersinia frederiksenii,29484,S,528,314,842,0.00008
Halomonas campaniensis,213554,S,90,54,144,0.00001
Mucilaginibacter sp. PAMC 26640,1300914,S,31,3,34,0
Burkholderia sp. IDO3,1705310,S,228,114,342,0.00003
Gordonia phage Hedwig,1887648,S,79,2,81,0.00001
Paraliobacillus sp. X-1125,2213194,S,43,1,44,0
Ralstonia pickettii,329,S,1950,913,2863,0.00028
Yersinia ruckeri,29486,S,238,7,245,0.00002
Deferribacter desulfuricans,197162,S,47,2,49,0
Sphingopyxis sp. 113P3,292913,S,2188,581,2769,0.00027
Streptomyces sp. MOE7,1961713,S,37,14,51,0.00001
Rhizobium favelukesii,348824,S,957,282,1239,0.00012
Sphingobium cloacae,120107,S,2352,1727,4079,0.0004
Pseudomonas yamanorum,515393,S,274,389,663,0.00007
Halobacteriovorax marinus,97084,S,150,0,150,0.00001
Candidatus Fokinia solitaria,1802984,S,16,0,16,0
Mariprofundus ferrinatatus,1921087,S,75,4,79,0.00001
Candidatus Arthromitus sp. SFB-rat-Yit,1041504,S,98,1,99,0.00001
Candidatus Endolissoclinum faulkneri,1263979,S,31,0,31,0
Halanaerobium praevalens,2331,S,62,47,109,0.00001
Lactobacillus allii,1847728,S,116,3,119,0.00001
Citrobacter braakii,57706,S,3496,6325,9821,0.00097
Tsukamurella tyrosinosolvens,57704,S,2623,499,3122,0.00031
Halomicrobium mukohataei,57705,S,27,0,27,0
Bacillus paralicheniformis,1648923,S,36,2,38,0
Glaciecola nitratireducens,300231,S,37,0,37,0
Caldisericum exile,693075,S,16,0,16,0
Corynebacterium camporealensis,161896,S,73,3,76,0.00001
Corynebacterium phocae,161895,S,53,1,54,0.00001
Synechococcus sp. KORDI-100,1280380,S,38,3,41,0
Pediococcus damnosus,51663,S,63,12,75,0.00001
Arthrobacter alpinus,656366,S,430,29,459,0.00005
Myroides sp. ZB35,1458492,S,12,9,21,0
Aerococcus urinaeequi,51665,S,337,41,378,0.00004
Leptolyngbya sp. PCC 7376,111781,S,17,1,18,0
Streptococcus sp. NPS 308,1902136,S,323,35,358,0.00004
Tetragenococcus halophilus,51669,S,208,20,228,0.00002
Marinobacterium aestuarii,1821621,S,329,5,334,0.00003
Lactobacillus plantarum,1590,S,2301,3920,6221,0.00061
Desulfofarcimen acetoxidans,58138,S,126,1,127,0.00001
Rhizobium phage RR1-B,929834,S,10,0,10,0
Anaerostipes hadrus,649756,S,50531,4435,54966,0.00542
Turicibacter sp. H121,1712675,S,2287,93,2380,0.00023
Staphylococcus sciuri,1296,S,79,3,82,0.00001
Corynebacterium kroppenstedtii,161879,S,75,2,77,0.00001
Martelella mediterranea,293089,S,1445,306,1751,0.00017
Pseudomonas sp. ATCC 13867,1294143,S,1341,77,1418,0.00014
Actinomyces meyeri,52773,S,434,32,466,0.00005
Sphingopyxis sp. EG6,1874061,S,3241,1206,4447,0.00044
Edwardsiella phage PEi20,1608310,S,27,0,27,0
Burkholderia territorii,1503055,S,156,77,233,0.00002
Burkholderia stagnalis,1503054,S,192,56,248,0.00002
Shewanella frigidimarina,56812,S,162,14,176,0.00002
Candidatus Desulforudis audaxviator,471827,S,96,0,96,0.00001
Rothia mucilaginosa,43675,S,1641,79,1720,0.00017
Laribacter hongkongensis,168471,S,5374,1146,6520,0.00064
Magnetospira sp. QH-2,1288970,S,198,2,200,0.00002
Lactobacillus sakei,1599,S,310,21,331,0.00003
Maribacter sp. HTCC2170,313603,S,51,1,52,0.00001
Actinomyces sp. Chiba101,1851395,S,134,73,207,0.00002
Vibrio tapetis,52443,S,79,1,80,0.00001
Prevotella dentalis,52227,S,170,36,206,0.00002
Thauera chlorobenzoica,96773,S,1715,634,2349,0.00023
Haloferax volcanii,2246,S,18,9,27,0
Leptospira mayottensis,1137606,S,14,1,15,0
Pseudomonas sp. GR 6-02,1659194,S,375,155,530,0.00005
Desulfurivibrio alkaliphilus,427923,S,301,14,315,0.00003
Halobacterium salinarum,2242,S,19,-19,0,0
Akkermansia muciniphila,239935,S,143100,386,143486,0.01414
Solitalea canadensis,995,S,110,2,112,0.00001
Corynebacterium marinum,349751,S,226,27,253,0.00002
Flavobacterium columnare,996,S,1138,116,1254,0.00012
Marinobacter sp. CP1,1671721,S,200,110,310,0.00003
Chromatiaceae bacterium 2141T.STBD.0c.01a,1978339,S,218,3,221,0.00002
Bernardetia litoralis,999,S,79,1,80,0.00001
Thiobacillus denitrificans,36861,S,634,41,675,0.00007
Enterobacter kobei,208224,S,1056,2073,3129,0.00031
Alkaliphilus metalliredigens,208226,S,383,10,393,0.00004
Euzebya sp. DY32-46,1608957,S,250,1,251,0.00002
Kosakonia cowanii,208223,S,803,17,820,0.00008
Isosphaera pallida,128,S,65,0,65,0.00001
Burkholderia ambifaria,152480,S,221,75,296,0.00003
Anaerolineaceae bacterium oral taxon 439,1889813,S,102,0,102,0.00001
Pseudomonas lini,163011,S,572,68,640,0.00006
Serinicoccus sp. JLT9,1758689,S,476,79,555,0.00005
Micropruina glycogenica,75385,S,27555,3503,31058,0.00306
Staphylococcus schleiferi,1295,S,33,1,34,0
Burkholderia sp. NRF60-BP8,1637853,S,88,48,136,0.00001
Parasaccharibacter apium,1510841,S,55,1,56,0.00001
Hyphomicrobium denitrificans,53399,S,742,120,862,0.00008
Pseudomonas umsongensis,198618,S,775,62,837,0.00008
Blattabacterium cuenoti,1653831,S,31,6,37,0
Escherichia phage Envy,1883200,S,15,10,25,0
Helicobacter saguini,1548018,S,16,0,16,0
Escherichia phage Gluttony,1883202,S,17,11,28,0
Moraxella bovoculi,386891,S,8185,3323,11508,0.00113
Nostoc flagelliforme,1306274,S,28,23,51,0.00001
Streptococcus dysgalactiae,1334,S,6788,5510,12298,0.00121
Pasteurellaceae bacterium NI1060,1679001,S,85,3,88,0.00001
Kitasatospora setae,2066,S,215,57,272,0.00003
Mycoplasma hyosynoviae,29559,S,27,1,28,0
Formosa agariphila,320324,S,154,10,164,0.00002
Paenibacillus sp. Y412MC10,481743,S,26,12,38,0
Halomonas sp. SF2003,2136172,S,288,84,372,0.00004
Enterococcus sp. FDAARGOS_163,2060306,S,153,658,811,0.00008
Adlercreutzia equolifaciens,446660,S,4578,418,4996,0.00049
Staphylococcus agnetis,985762,S,19,1,20,0
Lactobacillus sp. HBUAS52074,2304606,S,133,1,134,0.00001
Gordonia phage GRU1,1109710,S,20,0,20,0
Micromonospora aurantiaca,47850,S,70,398,468,0.00005
Polaribacter sp. KT25b,1855336,S,163,15,178,0.00002
Cutibacterium avidum,33010,S,342,49,391,0.00004
Burkholderia cenocepacia,95486,S,803,1558,2361,0.00023
Burkholderia stabilis,95485,S,193,126,319,0.00003
Micromonospora sp. WMMA2032,2039870,S,134,59,193,0.00002
Mycobacterium canettii,78331,S,214,88,302,0.00003
Legionella clemsonensis,1867846,S,46,15,61,0.00001
Campylobacter sp. NCTC 13003,1660064,S,11,0,11,0
Bacillus coagulans,1398,S,386,26,412,0.00004
Pantoea calida,665913,S,29,103,132,0.00001
Providencia phage Redjac,1235559,S,18,0,18,0
Streptomyces sp. 3214.6,1882757,S,107,10,117,0.00001
Xylella taiwanensis,1444770,S,178,12,190,0.00002
Thermosynechococcus elongatus,146786,S,10,2,12,0
Pantoea gaviniae,665914,S,189,12,201,0.00002
Azoarcus sp. CIB,198107,S,1645,93,1738,0.00017
Candidatus Cloacimonas acidaminovorans,456827,S,1001,0,1001,0.0001
Polaribacter reichenbachii,996801,S,252,23,275,0.00003
Pseudomonas extremorientalis,169669,S,762,316,1078,0.00011
Variovorax sp. PMC12,2126319,S,5007,2231,7238,0.00071
Candidatus Fukatsuia symbiotica,1878942,S,52,0,52,0.00001
Methylotenera versatilis,1055487,S,86,7,93,0.00001
Bradyrhizobium sp. CCGE-LA001,1223566,S,603,92,695,0.00007
Desulfallas gibsoniae,102134,S,110,1,111,0.00001
Rhodococcus ruber,1830,S,451,104,555,0.00005
Gemmata sp. SH-PL17,1630693,S,155,7,162,0.00002
Pseudomonas pohangensis,364197,S,4969,66,5035,0.0005
Salmonella virus Chi,1541887,S,23,34,57,0.00001
Shewanella pealeana,70864,S,45,1,46,0
Dehalogenimonas lykanthroporepellens,552810,S,216,27,243,0.00002
Shewanella oneidensis,70863,S,159,7,166,0.00002
Oscillatoriales cyanobacterium JSC-12,864702,S,13,1,14,0
Agrobacterium fabrum,1176649,S,1600,416,2016,0.0002
Erwinia phage vB_EamM_ChrisDB,1883371,S,91,4,95,0.00001
Listeria seeligeri,1640,S,40,3,43,0
Idiomarina sp. X4,2055892,S,40,13,53,0.00001
Malacobacter marinus,505249,S,279,62,341,0.00003
Streptomyces cattleya,29303,S,206,23,229,0.00002
Bacillus cereus,1396,S,1736,705,2441,0.00024
Bordetella genomosp. 8,1416806,S,605,41,646,0.00006
Aeromonas rivipollensis,948519,S,5396,957,6353,0.00063
Erysipelothrix rhusiopathiae,1648,S,234,25,259,0.00003
Epibacterium mobile,379347,S,351,107,458,0.00005
Lactococcus phage M5938,1862960,S,55,108,163,0.00002
Elizabethkingia bruuniana,1756149,S,887,962,1849,0.00018
Lactococcus phage M6165,1862962,S,83,47,130,0.00001
Enterobacteriaceae bacterium strain FGI 57,693444,S,2641,77,2718,0.00027
Cupriavidus taiwanensis,164546,S,4165,1064,5229,0.00052
Nocardia nova,37330,S,329,41,370,0.00004
Nocardia seriolae,37332,S,380,58,438,0.00004
Burkholderia virus KL1,1921548,S,66,0,66,0.00001
Pseudarthrobacter sulfonivorans,121292,S,147,13,160,0.00002
Vibrio splendidus,29497,S,36,4,40,0
Candidatus Promineofilum breve,1806508,S,357,1,358,0.00004
Vibrio furnissii,29494,S,99,7,106,0.00001
Klebsiella pneumoniae,573,S,39726,29904,69630,0.00686
Geobacillus sp. WCH70,471223,S,67,66,133,0.00001
Klebsiella oxytoca,571,S,10142,11621,21763,0.00214
Vibrio tubiashii,29498,S,30,1,31,0
Pseudomonas virus 73,1921545,S,50,85,135,0.00001
Raoultella planticola,575,S,7665,1656,9321,0.00092
Porphyromonas crevioricanis,393921,S,31,5,36,0
Pseudoarcobacter suis,1278212,S,4550,448,4998,0.00049
Planktothrix agardhii,1160,S,65,6,71,0.00001
Coriobacterium glomerans,33871,S,173,0,173,0.00002
Pseudomonas kribbensis,1628086,S,565,90,655,0.00006
Tessaracoccus aquimaris,1332264,S,10341,1514,11855,0.00117
Lysinibacillus sphaericus,1421,S,55,128,183,0.00002
Natrinema sp. J7-2,406552,S,15,8,23,0
Pelobacter propionicus,29543,S,900,115,1015,0.0001
Pelobacter acetylenicus,29542,S,212,21,233,0.00002
Mycolicibacter sinensis,875328,S,1456,269,1725,0.00017
Lawsonia intracellularis,29546,S,55,-55,0,0
Enterococcus sp. CR-Ec1,2057791,S,190,763,953,0.00009
Glaesserella sp. 15-184,2030797,S,63,5,68,0.00001
Pseudomonas xanthomarina,271420,S,403,27,430,0.00004
Planococcus halocryophilus,1215089,S,32,6,38,0
Blautia sp. N6H1-15,1912897,S,3535,350,3885,0.00038
Histophilus somni,731,S,111,19,130,0.00001
[Haemophilus] ducreyi,730,S,43,4,47,0
Aggregatibacter aphrophilus,732,S,237,36,273,0.00003
Aggregatibacter segnis,739,S,127,25,152,0.00001
Glaesserella parasuis,738,S,182,18,200,0.00002
Roseateles depolymerans,76731,S,2148,416,2564,0.00025
Lactococcus lactis,1358,S,30413,8896,39309,0.00387
Corynebacterium resistens,258224,S,87,25,112,0.00001
Flavobacterium sp. HYN0049,2172098,S,128,4,132,0.00001
Catenovulum sp. CCB-QB4,2172099,S,41,0,41,0
Enterococcus faecalis,1351,S,2797,441,3238,0.00032
Ruegeria pomeroyi,89184,S,1106,99,1205,0.00012
Burkholderia sp. KJ006,416344,S,10,85,95,0.00001
Enterococcus hirae,1354,S,2818,422,3240,0.00032
Prosthecochloris sp. HL-130-GSB,1974213,S,56,2,58,0.00001
Nonlabens spongiae,331648,S,54,33,87,0.00001
Methanoculleus bourgensis,83986,S,11,22,33,0
Lachnospiraceae bacterium GAM79,2109691,S,16676,2995,19671,0.00194
Citrobacter phage CR44b,1455075,S,17,7,24,0
Nocardia cyriacigeorgica,135487,S,592,176,768,0.00008
Polynucleobacter duraquae,1835254,S,59,9,68,0.00001
Lactococcus phage 1706,475178,S,17,1,18,0
Exiguobacterium sp. U13-1,1849031,S,20,71,91,0.00001
Arthrobacter sp. U41,1849032,S,227,19,246,0.00002
Salipiger profundus,1229727,S,1042,862,1904,0.00019
Parvibaculum lavamentivorans,256618,S,1195,384,1579,0.00016
Stenotrophomonas sp. G4,2303750,S,632,766,1398,0.00014
Sphingopyxis granuli,267128,S,2123,5640,7763,0.00077
Hungateiclostridium thermocellum,1515,S,132,52,184,0.00002
Pseudomonas xinjiangensis,487184,S,252,2,254,0.00003
Streptococcus australis,113107,S,1067,126,1193,0.00012
Acetoanaerobium sticklandii,1511,S,126753,832,127585,0.01257
Thermoclostridium stercorarium,1510,S,68,12,80,0.00001
Clostridium tetani,1513,S,113,1,114,0.00001
Enterobacteriaceae bacterium ENNIH3,1920128,S,10,558,568,0.00006
Flavobacterium arcticum,1784713,S,176,5,181,0.00002
Enterobacter phage phiEap-2,1701257,S,62,0,62,0.00001
Photobacterium gaetbulicola,1295392,S,84,1,85,0.00001
Salmonella phage Vi II-E1,424716,S,56,5,61,0.00001
Janthinobacterium svalbardensis,368607,S,19489,3748,23237,0.00229
Actinoalloteichus hymeniacidonis,340345,S,168,51,219,0.00002
Coraliomargarita akajimensis,395922,S,42,0,42,0
Corynebacterium timonense,441500,S,104,6,110,0.00001
Bacillus amyloliquefaciens,1390,S,120,457,577,0.00006
Sphingobacterium sp. G1-14,2003121,S,355,188,543,0.00005
Agromyces aureus,453304,S,761,176,937,0.00009
Capnocytophaga leadbetteri,327575,S,71,6,77,0.00001
Candidatus Xiphinematobacter sp. Idaho Grape,1704307,S,23,0,23,0
Aquiflexum balticum,280473,S,129,4,133,0.00001
Streptomyces sp. Mg1,465541,S,108,13,121,0.00001
Mycobacterium chimaera,222805,S,575,486,1061,0.0001
Kytococcus sedentarius,1276,S,528,173,701,0.00007
Saccharothrix espanaensis,103731,S,324,74,398,0.00004
Streptococcus sp. oral taxon 064,712624,S,39,26,65,0.00001
Lacinutrix sp. Bg11-31,2057808,S,132,11,143,0.00001
Geobacter sulfurreducens,35554,S,909,459,1368,0.00013
Deinococcus ficus,317577,S,131,6,137,0.00001
Neisseriaceae bacterium DSM 100970,2052837,S,25,0,25,0
Aeromonas virus Aes12,1921530,S,52,22,74,0.00001
Aminomonas paucivorans,81412,S,607,90,697,0.00007
Massilia sp. WG5,1707785,S,866,306,1172,0.00012
Pseudomonas virus PaMx11,1982098,S,40,0,40,0
Candidatus Liberibacter americanus,309868,S,16,1,17,0
Thermosynechococcus sp. NK55a,1394889,S,11,3,14,0
Nitrosospira briensis,35799,S,168,14,182,0.00002
Kribbella flavida,182640,S,469,47,516,0.00005
Bordetella sp. H567,1697043,S,523,32,555,0.00005
Rhodoplanes sp. Z2-YC6860,674703,S,726,38,764,0.00008
Shewanella woodyi,60961,S,47,1,48,0
Salinarchaeum sp. Harcht-Bsk1,1333523,S,32,0,32,0
Calothrix sp. NIES-3974,2005462,S,14,0,14,0
Azotobacter vinelandii,354,S,553,-553,0,0
Azotobacter chroococcum,353,S,720,155,875,0.00009
Klebsiella phage JD001,1236000,S,91,0,91,0.00001
Phycicoccus dokdonensis,443156,S,791,121,912,0.00009
Magnetospirillum sp. XM-1,1663591,S,422,201,623,0.00006
Spiroplasma monobiae,2136,S,11,3,14,0
Agrobacterium rhizogenes,359,S,2503,462,2965,0.00029
Agrobacterium tumefaciens,358,S,6211,4729,10940,0.00108
Escherichia marmotae,1499973,S,1805,142,1947,0.00019
[Enterobacter] lignolyticus,1334193,S,976,30,1006,0.0001
Hyphomonas sp. CACIAM 19H1,1873716,S,280,41,321,0.00003
Mycobacterium virus Acadian,1982901,S,11,2,13,0
Acinetobacter equi,1324350,S,913,18,931,0.00009
Chryseobacterium gallinarum,1324352,S,626,336,962,0.00009
Gordonia iterans,1004901,S,1140,322,1462,0.00014
Pseudomonas sp. 02C 26,2054914,S,744,30,774,0.00008
Pseudomonas sp. 09C 129,2054915,S,288,194,482,0.00005
Blastomonas fulva,1550728,S,523,443,966,0.0001
Humibacter sp. BT305,2282656,S,265,2496,2761,0.00027
Sinorhizobium medicae,110321,S,878,139,1017,0.0001
Gordonia phage Phinally,1821560,S,389,0,389,0.00004
Marinovum algicola,42444,S,1180,642,1822,0.00018
Roseobacter litoralis,42443,S,200,40,240,0.00002
Mahella australiensis,252966,S,94,15,109,0.00001
Chromohalobacter salexigens,158080,S,248,10,258,0.00003
Methyloceanibacter caenitepidi,1384459,S,183,44,227,0.00002
Lactococcus virus Bibb29,494269,S,97,34,131,0.00001
Pseudomonas sp. phDV1,253237,S,1218,2084,3302,0.00033
Cyanothece sp. PCC 7424,65393,S,13,2,15,0
Paracoccus zhejiangensis,1077935,S,6431,1274,7705,0.00076
Ethanoligenens harbinense,253239,S,805,6,811,0.00008
Helicobacter apodemus,135569,S,11,0,11,0
Sodalis virus SO1,1954380,S,37,8,45,0
Pseudoalteromonas atlantica,288,S,86,22,108,0.00001
Methanobacterium lacus,877455,S,71,0,71,0.00001
Deinococcus radiodurans,1299,S,96,23,119,0.00001
Jiangella alkaliphila,419479,S,331,81,412,0.00004
Xanthobacter autotrophicus,280,S,4517,1147,5664,0.00056
Bacillus kochii,859143,S,69,2,71,0.00001
Comamonas testosteroni,285,S,46728,9528,56256,0.00554
Pseudomonas aeruginosa,287,S,27904,21697,49601,0.00489
Pectobacterium phage PP90,1873959,S,48,20,68,0.00001
Fischerella sp. NIES-3754,1752063,S,17,10,27,0
Haloquadratum walsbyi,293091,S,19,-19,0,0
Streptomyces xiamenensis,408015,S,166,15,181,0.00002
Nostocales cyanobacterium HT-58-2,1940762,S,15,1,16,0
Leptolyngbya sp. NIES-3755,1752064,S,22,1,23,0
Sulfurihydrogenibium sp. YO3AOP1,436114,S,16,9,25,0
Phaeobacter inhibens,221822,S,638,279,917,0.00009
Desulfobacterium autotrophicum,2296,S,105,3,108,0.00001
Francisella tularensis,263,S,71,38,109,0.00001
Roseburia hominis,301301,S,21580,5489,27069,0.00267
Paraphotobacterium marinum,1755811,S,19,0,19,0
Polaribacter vadi,1774273,S,150,11,161,0.00002
Paracoccus denitrificans,266,S,7214,1296,8510,0.00084
Clostridium baratii,1561,S,263,4,267,0.00003
Thalassococcus sp. SH-1,2109625,S,1033,76,1109,0.00011
Zoogloeaceae bacteirum Par-f-2,2080469,S,479,1408,1887,0.00019
Komagataeibacter rhaeticus,215221,S,18,188,206,0.00002
Immundisolibacter cernigliae,1810504,S,613,13,626,0.00006
Tsukamurella phage TPA2,981330,S,20,0,20,0
Shewanella benthica,43661,S,34,2,36,0
Pseudoalteromonas piscicida,43662,S,62,12,74,0.00001
Paenarthrobacter aurescens,43663,S,48,296,344,0.00003
Streptomyces atratus,1893,S,122,10,132,0.00001
Methylobacterium phyllosphaerae,418223,S,205,505,710,0.00007
Brenneria sp. EniD312,598467,S,165,7,172,0.00002
Rhizobium sp. NT-26,1125847,S,1778,207,1985,0.0002
Methylophaga frappieri,754477,S,155,22,177,0.00002
Methylophaga nitratireducenticrescens,754476,S,164,2,166,0.00002
Marinobacter similis,1420916,S,134,3,137,0.00001
Rhizobium gallicum,56730,S,1049,128,1177,0.00012
Campylobacter sp. RM6137,1660073,S,18,0,18,0
Mycolicibacterium gilvum,1804,S,2017,1245,3262,0.00032
Natronomonas pharaonis,2257,S,29,1,30,0
Martelella sp. AD-3,686597,S,1636,463,2099,0.00021
Clostridium bornimense,1216932,S,231,14,245,0.00002
Gloeomargarita lithophora,1188228,S,82,0,82,0.00001
Pseudomonas avellanae,46257,S,46,382,428,0.00004
Rhodoferax saidenbachensis,1484693,S,8404,414,8818,0.00087
Cryobacterium sp. GCJ02,2220095,S,202,116,318,0.00003
Actinoplanes derwentensis,113562,S,239,80,319,0.00003
Natronolimnobius aegyptiacus,745377,S,16,13,29,0
Pedobacter heparinus,984,S,88,9,97,0.00001
Desulfitobacterium dehalogenans,36854,S,56,4,60,0.00001
Flavobacterium sp. MEBiC07310,2201181,S,1440,54,1494,0.00015
Gemmata obscuriglobus,114,S,194,13,207,0.00002
Acidisphaera sp. G45-3,1969806,S,349,14,363,0.00004
Bradyrhizobium sp. 2 39S1MB,1404768,S,356,131,487,0.00005
Chryseobacterium indologenes,253,S,2091,1027,3118,0.00031
Bacillus altitudinis,293387,S,12,12,24,0
Gordonia phage GTE5,319522,S,28,1,29,0
Rubinisphaera brasiliensis,119,S,45,1,46,0
Methanobacterium sp. MB1,1379702,S,73,10,83,0.00001
Mageeibacillus indolicus,884684,S,268,15,283,0.00003
Mesorhizobium sp. DCY119,2108445,S,964,165,1129,0.00011
Denitrovibrio acetiphilus,118000,S,19,0,19,0
Gammaproteobacteria bacterium DM2,2169539,S,62,1,63,0.00001
Pseudomonas koreensis,198620,S,6895,1496,8391,0.00083
Desulfurispirillum indicum,936456,S,87,2,89,0.00001
Bordetella flabilis,463014,S,494,24,518,0.00005
Mycolicibacterium thermoresistibile,1797,S,854,127,981,0.0001
Pseudorhodoplanes sinuspersici,1235591,S,720,35,755,0.00007
Mannheimia varigena,85404,S,95,23,118,0.00001
Candidatus Arthromitus sp. SFB-mouse,49118,S,77,43,120,0.00001
Mycolicibacterium goodii,134601,S,1091,318,1409,0.00014
Lactococcus phage P162,1476889,S,15,15,30,0
Macrococcus sp. IME1552,1898474,S,80,21,101,0.00001
Megasphaera hexanoica,1675036,S,396,40,436,0.00004
Staphylococcus condimenti,70255,S,31,2,33,0
Cylindrospermum stagnale,142864,S,15,3,18,0
Paenibacillus glucanolyticus,59843,S,89,9,98,0.00001
Staphylococcus piscifermentans,70258,S,34,1,35,0
Gloeobacter violaceus,33072,S,72,1,73,0.00001
Flavobacterium branchiophilum,55197,S,1523,50,1573,0.00016
Bacillus weihaiensis,1547283,S,106,5,111,0.00001
Pseudomonas sp. LAB-08,143813,S,665,66,731,0.00007
Altererythrobacter sp. B11,2060312,S,681,209,890,0.00009
Deinococcus actinosclerus,1768108,S,132,83,215,0.00002
Candidatus Desulfovibrio trichonymphae,1725232,S,339,8,347,0.00003
Bradyrhizobium sp. 3 85S1MB,1404367,S,382,136,518,0.00005
Serratia sp. MYb239,2033438,S,15,26,41,0
Sulfurospirillum barnesii,44674,S,84,2,86,0.00001
Micromonospora zamorensis,709883,S,121,26,147,0.00001
Pseudomonas viridiflava,33069,S,779,37,816,0.00008
Aneurinibacillus soli,1500254,S,61,5,66,0.00001
Chitinophaga sp. MD30,2033437,S,61,8,69,0.00001
Rhodobacteraceae bacterium QY30,2033435,S,2916,190,3106,0.00031
Bacillus krulwichiae,199441,S,37,8,45,0
Escherichia virus FFH2,1914856,S,153,104,257,0.00003
Methanosarcina mazei,2209,S,63,1,64,0.00001
Mycobacterium shigaense,722731,S,656,37,693,0.00007
Synechococcus sp. JA-2-3B'a(2-13),321332,S,76,76,152,0.00001
Methanosarcina horonobensis,418008,S,22,0,22,0
Stenotrophomonas phage vB_SmaS-DLP,1659230,S,21,26,47,0
Thiomicrospira cyclica,147268,S,74,6,80,0.00001
Psychrobacter sp. P11G3,1699623,S,8374,328,8702,0.00086
Shigella virus AG3,1987994,S,15,11,26,0
Psychrobacter sp. P11F6,1699621,S,63434,2371,65805,0.00649
Acinetobacter phage YMC13/03/R2096,1560342,S,36,0,36,0
Psychrobacter sp. P11G5,1699624,S,6878,8162,15040,0.00148
Haloplanus sp. CBA1113,1547899,S,10,23,33,0
Shigella virus SP18,1913995,S,15,4,19,0
Mycobacterium haemophilum,29311,S,266,3,269,0.00003
Corynebacterium crudilactis,1652495,S,35,6,41,0
Pseudomonas sp. UW4,1207075,S,754,78,832,0.00008
Candidatus Koribacter versatilis,658062,S,86,3,89,0.00001
Collimonas fungivorans,158899,S,927,176,1103,0.00011
Lactobacillus casei,1582,S,193,469,662,0.00007
Tannerella sp. oral taxon HOT-286,712710,S,193,13,206,0.00002
Fictibacillus arsenicus,255247,S,44,3,47,0
Thioalkalivibrio versutus,106634,S,239,17,256,0.00003
Actinomyces hongkongensis,178339,S,348,116,464,0.00005
halophilic archaeon DL31,756883,S,12,6,18,0
Lactobacillus fuchuensis,164393,S,341,2,343,0.00003
Pannonibacter phragmitetus,121719,S,2703,1348,4051,0.0004
Rhodobacter virus RcTitan,1982575,S,57,0,57,0.00001
Rhodococcus jostii,132919,S,185,27,212,0.00002
Leuconostoc garlicum,255248,S,590,335,925,0.00009
Tessaracoccus sp. Marseille-P5995,2161816,S,503,123,626,0.00006
Tsukamurella virus TIN3,1982571,S,38,5,43,0
Tsukamurella virus TIN2,1982570,S,21,3,24,0
Burkholderia sp. HB1,1678678,S,108,782,890,0.00009
Streptococcus respiraculi,2021971,S,1821,45,1866,0.00018
Nocardia farcinica,37329,S,425,183,608,0.00006
Nocardia brasiliensis,37326,S,519,83,602,0.00006
Capnocytophaga sp. oral taxon 878,1316596,S,54,11,65,0.00001
Taylorella asinigenitalis,84590,S,19,2,21,0
Streptomyces roseochromogenus,285450,S,84,7,91,0.00001
Komagataeibacter saccharivorans,265959,S,91,17,108,0.00001
Gordonia polyisoprenivorans,84595,S,12513,1151,13664,0.00135
Hafnia alvei,569,S,840,238,1078,0.00011
Cyanobium gracile,59930,S,176,32,208,0.00002
Thiohalobacter thiocyanaticus,585455,S,459,4,463,0.00005
Yersinia rohdei,29485,S,237,8,245,0.00002
Escherichia coli,562,S,75964,128949,204913,0.0202
Shimwellia blattae,563,S,328,6,334,0.00003
Escherichia fergusonii,564,S,339,81,420,0.00004
Mariprofundus aestuarium,1921086,S,65,4,69,0.00001
Yersinia aldovae,29483,S,142,6,148,0.00001
Altererythrobacter mangrovi,1982042,S,389,40,429,0.00004
Bacillus lehensis,300825,S,20,0,20,0
Mesoplasma lactucae,138853,S,12,1,13,0
Sphingomonas sp. LK11,1390395,S,3084,211,3295,0.00032
Thioalkalivibrio paradoxus,108010,S,232,83,315,0.00003
Edwardsiella piscicida,1263550,S,82,219,301,0.00003
Mycoplasma canadense,29554,S,15,3,18,0
Mycoplasma canis,29555,S,14,5,19,0
Leptolyngbya boryana,1184,S,23,2,25,0
Paracoccus mutanolyticus,1499308,S,1335,1720,3055,0.0003
Haemophilus haemolyticus,726,S,145,27,172,0.00002
Haemophilus influenzae,727,S,402,180,582,0.00006
Niabella ginsenosidivorans,1176587,S,58,12,70,0.00001
Sinomonas atrocyanea,37927,S,360,29,389,0.00004
Acidipropionibacterium acidipropionici,1748,S,595,252,847,0.00008
Thioploca ingrica,40754,S,57,0,57,0.00001
Nocardioides sp. CF8,110319,S,1035,208,1243,0.00012
Pseudomonas sp. A214,1855331,S,95,157,252,0.00002
Propionibacterium freudenreichii,1744,S,2769,3226,5995,0.00059
Pseudomonas prosekii,1148509,S,3563,286,3849,0.00038
Lactobacillus virus Lb338-1,632112,S,13,0,13,0
Cutibacterium acnes,1747,S,1121,215,1336,0.00013
Arthrobacter crystallopoietes,37928,S,236,20,256,0.00003
Thermodesulfobacterium commune,1741,S,11,3,14,0
Clostridium saccharobutylicum,169679,S,185,1,186,0.00002
Haemophilus parainfluenzae,729,S,2105,320,2425,0.00024
Trichormus azollae,1164,S,12,1,13,0
Anabaena cylindrica,1165,S,13,2,15,0
Streptomyces pratensis,1169025,S,30,25,55,0.00001
Citrobacter farmeri,67824,S,952,292,1244,0.00012
Citrobacter rodentium,67825,S,692,30,722,0.00007
Desulfomicrobium orale,132132,S,281,31,312,0.00003
Citrobacter werkmanii,67827,S,2880,438,3318,0.00033
Filifactor alocis,143361,S,271,12,283,0.00003
Erythrobacter sp. HL-111,1798193,S,439,41,480,0.00005
Maribacter sp. 1_2014MBL_MicDiv,1644130,S,18,42,60,0.00001
Janthinobacterium sp. 1_2014MBL_MicDiv,1644131,S,3274,634,3908,0.00039
Corynebacterium aurimucosum,169292,S,112,9,121,0.00001
Opitutaceae bacterium TAV5,794903,S,310,4,314,0.00003
Capnocytophaga sp. oral taxon 323,1705617,S,12,16,28,0
Xenorhabdus poinarii,40577,S,31,4,35,0
Xenorhabdus bovienii,40576,S,76,10,86,0.00001
Clostridium acetobutylicum,1488,S,97,0,97,0.00001
Archangium gephyra,48,S,270,70,340,0.00003
Bacillus filamentosus,1402861,S,46,1,47,0
Thermus sp. CCB_US3_UF1,1111069,S,31,5,36,0
Acinetobacter baumannii,470,S,13530,12506,26036,0.00257
Stigmatella aurantiaca,41,S,163,53,216,0.00002
Acinetobacter calcoaceticus,471,S,635,120,755,0.00007
Gallionella capsiferriformans,370405,S,244,23,267,0.00003
Bartonella australis,388640,S,22,4,26,0
Mycobacterium colombiense,339268,S,620,30,650,0.00006
Staphylococcus warneri,1292,S,36,9,45,0
Pelagibacterium halotolerans,531813,S,432,32,464,0.00005
Staphylococcus hominis,1290,S,404,25,429,0.00004
Desulfosporosinus orientis,1563,S,68,3,71,0.00001
Desulfotomaculum ruminis,1564,S,102,1,103,0.00001
Kosakonia radicincitans,283686,S,243,436,679,0.00007
Staphylococcus muscae,1294,S,25,0,25,0
Pandoraea thiooxydans,445709,S,891,37,928,0.00009
Candidatus Kinetoplastibacterium oncopeltii,994696,S,34,10,44,0
Flavobacterium indicum,312277,S,3468,157,3625,0.00036
Rhodococcus sp. p52,935199,S,79,247,326,0.00003
Pseudoalteromonas arctica,394751,S,22,8,30,0
Victivallales bacterium CCUG 44730,2094242,S,319,7,326,0.00003
Micromonospora siamensis,299152,S,144,51,195,0.00002
Geobacillus genomosp. 3,1921421,S,26,4,30,0
Sphingomonas panacis,1560345,S,819,20,839,0.00008
Spirosoma radiotolerans,1379870,S,40,5,45,0
Bifidobacterium longum,216816,S,76149,12970,89119,0.00878
Staphylococcus sp. M0911,2025492,S,183,25,208,0.00002
Erwinia phage vB_EamM_Huxley,1883373,S,17,0,17,0
Arcobacter nitrofigilis,28199,S,358,8,366,0.00004
Streptococcus phage SMP,413066,S,46,2,48,0
Mycobacterium avium,1764,S,1886,653,2539,0.00025
Aliiarcobacter butzleri,28197,S,5494,964,6458,0.00064
Gramella sp. SH35,2126553,S,57,5,62,0.00001
Candidatus Gullanella endobia,1070130,S,14,0,14,0
Aliiarcobacter skirrowii,28200,S,14712,1441,16153,0.00159
Lactococcus raffinolactis,1366,S,60479,7121,67600,0.00666
Breoghania sp. L-A4,2304600,S,846,47,893,0.00009
Vogesella sp. LIG4,1192162,S,861,98,959,0.00009
Moraxella bovis,476,S,728,50,778,0.00008
Lactococcus garvieae,1363,S,638,56,694,0.00007
Enterobacter cloacae complex sp. ECNIH7,1915310,S,830,1139,1969,0.00019
Bifidobacterium choerinum,35760,S,322,43,365,0.00004
Shewanella psychrophila,225848,S,32,0,32,0
Cohaesibacter sp. ES.047,1798205,S,217,4,221,0.00002
Methanobacterium subterraneum,59277,S,70,143,213,0.00002
Erwinia phage vB_EamM_EarlPhillipIV,1883372,S,10,1,11,0
